,Quarter,Minute,Point Differential,Wins,Losses,key,N
0,1,0,-26,0,60,10-26,60
1,1,0,-23,4,56,10-23,60
2,1,0,-22,7,53,10-22,60
3,1,0,-21,3,57,10-21,60
4,1,0,-20,4,56,10-20,60
5,1,0,-19,4,56,10-19,60
6,1,0,-18,8,52,10-18,60
7,1,0,-17,2,69,10-17,71
8,1,0,-16,6,54,10-16,60
9,1,0,-15,10,61,10-15,71
10,1,0,-14,15,60,10-14,75
11,1,0,-13,13,87,10-13,100
12,1,0,-12,15,97,10-12,112
13,1,0,-11,31,139,10-11,170
14,1,0,-10,25,130,10-10,155
15,1,0,-9,34,151,10-9,185
16,1,0,-8,49,160,10-8,209
17,1,0,-7,68,156,10-7,224
18,1,0,-6,67,219,10-6,286
19,1,0,-5,96,237,10-5,333
20,1,0,-4,110,240,10-4,350
21,1,0,-3,106,241,10-3,347
22,1,0,-2,134,237,10-2,371
23,1,0,-1,109,192,10-1,301
24,1,0,1,117,203,101,320
25,1,0,2,119,169,102,288
26,1,0,3,129,139,103,268
27,1,0,4,147,106,104,253
28,1,0,5,122,108,105,230
29,1,0,6,122,75,106,197
30,1,0,7,99,74,107,173
31,1,0,8,95,66,108,161
32,1,0,9,70,55,109,125
33,1,0,10,69,41,1010,110
34,1,0,11,53,30,1011,83
35,1,0,12,44,22,1012,66
36,1,0,13,42,18,1013,60
37,1,0,14,39,21,1014,60
38,1,0,15,39,21,1015,60
39,1,0,16,47,13,1016,60
40,1,0,17,43,17,1017,60
41,1,0,18,49,11,1018,60
42,1,0,19,55,5,1019,60
43,1,0,20,55,5,1020,60
44,1,0,21,55,5,1021,60
45,1,0,22,54,6,1022,60
46,1,0,23,59,1,1023,60
47,1,0,24,59,1,1024,60
48,1,0,25,60,0,1025,60
49,1,0,26,60,0,1026,60
50,1,1,-28,0,60,11-28,60
51,1,1,-26,0,60,11-26,60
52,1,1,-25,0,60,11-25,60
53,1,1,-23,3,57,11-23,60
54,1,1,-22,4,56,11-22,60
55,1,1,-21,4,56,11-21,60
56,1,1,-20,4,56,11-20,60
57,1,1,-19,3,57,11-19,60
58,1,1,-18,7,53,11-18,60
59,1,1,-17,4,56,11-17,60
60,1,1,-16,8,52,11-16,60
61,1,1,-15,7,53,11-15,60
62,1,1,-14,6,54,11-14,60
63,1,1,-13,8,52,11-13,60
64,1,1,-12,9,51,11-12,60
65,1,1,-11,10,68,11-11,78
66,1,1,-10,25,87,11-10,112
67,1,1,-9,33,99,11-9,132
68,1,1,-8,38,123,11-8,161
69,1,1,-7,56,140,11-7,196
70,1,1,-6,48,144,11-6,192
71,1,1,-5,51,140,11-5,191
72,1,1,-4,62,144,11-4,206
73,1,1,-3,80,143,11-3,223
74,1,1,-2,75,157,11-2,232
75,1,1,-1,62,145,11-1,207
76,1,1,1,75,105,111,180
77,1,1,2,104,98,112,202
78,1,1,3,76,78,113,154
79,1,1,4,87,78,114,165
80,1,1,5,73,66,115,139
81,1,1,6,65,61,116,126
82,1,1,7,72,61,117,133
83,1,1,8,58,45,118,103
84,1,1,9,62,42,119,104
85,1,1,10,49,31,1110,80
86,1,1,11,41,19,1111,60
87,1,1,12,42,18,1112,60
88,1,1,13,43,17,1113,60
89,1,1,14,36,24,1114,60
90,1,1,15,43,17,1115,60
91,1,1,16,44,16,1116,60
92,1,1,17,47,13,1117,60
93,1,1,18,55,5,1118,60
94,1,1,19,57,3,1119,60
95,1,1,20,57,3,1120,60
96,1,1,21,54,6,1121,60
97,1,1,22,54,6,1122,60
98,1,1,23,57,3,1123,60
99,1,1,24,56,4,1124,60
100,1,1,27,59,1,1127,60
101,1,2,-24,1,59,12-24,60
102,1,2,-23,4,56,12-23,60
103,1,2,-22,2,58,12-22,60
104,1,2,-21,1,59,12-21,60
105,1,2,-20,3,57,12-20,60
106,1,2,-19,5,55,12-19,60
107,1,2,-18,4,56,12-18,60
108,1,2,-17,5,55,12-17,60
109,1,2,-16,2,58,12-16,60
110,1,2,-15,6,54,12-15,60
111,1,2,-14,10,50,12-14,60
112,1,2,-13,8,52,12-13,60
113,1,2,-12,12,54,12-12,66
114,1,2,-11,11,61,12-11,72
115,1,2,-10,16,83,12-10,99
116,1,2,-9,35,104,12-9,139
117,1,2,-8,31,122,12-8,153
118,1,2,-7,43,111,12-7,154
119,1,2,-6,49,130,12-6,179
120,1,2,-5,57,132,12-5,189
121,1,2,-4,56,159,12-4,215
122,1,2,-3,55,144,12-3,199
123,1,2,-2,68,144,12-2,212
124,1,2,-1,69,130,12-1,199
125,1,2,1,88,106,121,194
126,1,2,2,85,112,122,197
127,1,2,3,85,79,123,164
128,1,2,4,72,80,124,152
129,1,2,5,63,66,125,129
130,1,2,6,55,61,126,116
131,1,2,7,59,56,127,115
132,1,2,8,52,50,128,102
133,1,2,9,50,44,129,94
134,1,2,10,37,28,1210,65
135,1,2,11,37,23,1211,60
136,1,2,12,40,20,1212,60
137,1,2,13,39,21,1213,60
138,1,2,14,40,20,1214,60
139,1,2,15,41,19,1215,60
140,1,2,16,43,17,1216,60
141,1,2,17,49,11,1217,60
142,1,2,18,54,6,1218,60
143,1,2,19,47,13,1219,60
144,1,2,20,54,6,1220,60
145,1,2,21,58,2,1221,60
146,1,2,22,49,11,1222,60
147,1,2,23,59,1,1223,60
148,1,2,25,59,1,1225,60
149,1,2,26,59,1,1226,60
150,1,2,28,56,4,1228,60
151,1,3,-22,2,58,13-22,60
152,1,3,-21,5,55,13-21,60
153,1,3,-20,6,54,13-20,60
154,1,3,-19,5,55,13-19,60
155,1,3,-18,3,57,13-18,60
156,1,3,-17,4,56,13-17,60
157,1,3,-16,14,46,13-16,60
158,1,3,-15,8,52,13-15,60
159,1,3,-14,6,54,13-14,60
160,1,3,-13,8,52,13-13,60
161,1,3,-12,10,51,13-12,61
162,1,3,-11,12,60,13-11,72
163,1,3,-10,15,84,13-10,99
164,1,3,-9,25,83,13-9,108
165,1,3,-8,36,110,13-8,146
166,1,3,-7,47,117,13-7,164
167,1,3,-6,47,140,13-6,187
168,1,3,-5,63,141,13-5,204
169,1,3,-4,66,141,13-4,207
170,1,3,-3,64,135,13-3,199
171,1,3,-2,73,139,13-2,212
172,1,3,-1,99,122,13-1,221
173,1,3,1,94,123,131,217
174,1,3,2,96,107,132,203
175,1,3,3,75,96,133,171
176,1,3,4,92,78,134,170
177,1,3,5,75,93,135,168
178,1,3,6,78,57,136,135
179,1,3,7,68,52,137,120
180,1,3,8,68,37,138,105
181,1,3,9,50,29,139,79
182,1,3,10,39,21,1310,60
183,1,3,11,41,23,1311,64
184,1,3,12,39,21,1312,60
185,1,3,13,38,22,1313,60
186,1,3,14,43,17,1314,60
187,1,3,15,44,16,1315,60
188,1,3,16,36,24,1316,60
189,1,3,17,53,7,1317,60
190,1,3,18,54,6,1318,60
191,1,3,19,55,5,1319,60
192,1,3,20,55,5,1320,60
193,1,3,22,52,8,1322,60
194,1,3,24,58,2,1324,60
195,1,3,25,60,0,1325,60
196,1,4,-22,3,57,14-22,60
197,1,4,-20,4,56,14-20,60
198,1,4,-19,5,55,14-19,60
199,1,4,-18,3,57,14-18,60
200,1,4,-17,5,55,14-17,60
201,1,4,-16,7,53,14-16,60
202,1,4,-15,7,53,14-15,60
203,1,4,-14,9,51,14-14,60
204,1,4,-13,8,52,14-13,60
205,1,4,-12,6,54,14-12,60
206,1,4,-11,9,54,14-11,63
207,1,4,-10,21,83,14-10,104
208,1,4,-9,17,66,14-9,83
209,1,4,-8,36,101,14-8,137
210,1,4,-7,39,108,14-7,147
211,1,4,-6,56,149,14-6,205
212,1,4,-5,48,133,14-5,181
213,1,4,-4,77,171,14-4,248
214,1,4,-3,78,147,14-3,225
215,1,4,-2,74,181,14-2,255
216,1,4,-1,72,153,14-1,225
217,1,4,1,100,131,141,231
218,1,4,2,91,110,142,201
219,1,4,3,91,125,143,216
220,1,4,4,79,92,144,171
221,1,4,5,63,79,145,142
222,1,4,6,63,62,146,125
223,1,4,7,53,52,147,105
224,1,4,8,60,33,148,93
225,1,4,9,60,30,149,90
226,1,4,10,48,20,1410,68
227,1,4,11,38,22,1411,60
228,1,4,12,36,24,1412,60
229,1,4,13,37,23,1413,60
230,1,4,14,39,21,1414,60
231,1,4,15,39,21,1415,60
232,1,4,16,49,11,1416,60
233,1,4,17,50,10,1417,60
234,1,4,18,45,15,1418,60
235,1,4,21,56,4,1421,60
236,1,4,23,57,3,1423,60
237,1,4,26,59,1,1426,60
238,1,5,-21,4,56,15-21,60
239,1,5,-20,7,53,15-20,60
240,1,5,-19,5,55,15-19,60
241,1,5,-18,5,55,15-18,60
242,1,5,-17,8,52,15-17,60
243,1,5,-16,7,53,15-16,60
244,1,5,-15,8,52,15-15,60
245,1,5,-14,9,51,15-14,60
246,1,5,-13,11,49,15-13,60
247,1,5,-12,7,53,15-12,60
248,1,5,-11,9,54,15-11,63
249,1,5,-10,14,60,15-10,74
250,1,5,-9,23,63,15-9,86
251,1,5,-8,27,99,15-8,126
252,1,5,-7,42,112,15-7,154
253,1,5,-6,36,159,15-6,195
254,1,5,-5,54,130,15-5,184
255,1,5,-4,52,139,15-4,191
256,1,5,-3,66,149,15-3,215
257,1,5,-2,86,147,15-2,233
258,1,5,-1,92,178,15-1,270
259,1,5,1,86,131,151,217
260,1,5,2,101,133,152,234
261,1,5,3,85,96,153,181
262,1,5,4,90,96,154,186
263,1,5,5,77,84,155,161
264,1,5,6,68,56,156,124
265,1,5,7,70,46,157,116
266,1,5,8,48,31,158,79
267,1,5,9,39,29,159,68
268,1,5,10,41,22,1510,63
269,1,5,11,39,21,1511,60
270,1,5,12,36,24,1512,60
271,1,5,13,42,18,1513,60
272,1,5,14,44,16,1514,60
273,1,5,15,43,17,1515,60
274,1,5,16,41,19,1516,60
275,1,5,21,56,4,1521,60
276,1,5,22,55,5,1522,60
277,1,5,23,58,2,1523,60
278,1,6,-21,4,56,16-21,60
279,1,6,-19,2,58,16-19,60
280,1,6,-18,9,51,16-18,60
281,1,6,-17,6,54,16-17,60
282,1,6,-16,5,55,16-16,60
283,1,6,-15,5,55,16-15,60
284,1,6,-14,5,55,16-14,60
285,1,6,-13,7,53,16-13,60
286,1,6,-12,10,50,16-12,60
287,1,6,-11,9,51,16-11,60
288,1,6,-10,16,48,16-10,64
289,1,6,-9,20,66,16-9,86
290,1,6,-8,37,92,16-8,129
291,1,6,-7,44,94,16-7,138
292,1,6,-6,44,130,16-6,174
293,1,6,-5,52,151,16-5,203
294,1,6,-4,70,161,16-4,231
295,1,6,-3,80,180,16-3,260
296,1,6,-2,85,172,16-2,257
297,1,6,-1,81,182,16-1,263
298,1,6,1,95,156,161,251
299,1,6,2,101,156,162,257
300,1,6,3,89,124,163,213
301,1,6,4,96,106,164,202
302,1,6,5,84,72,165,156
303,1,6,6,70,71,166,141
304,1,6,7,58,58,167,116
305,1,6,8,47,34,168,81
306,1,6,9,32,28,169,60
307,1,6,10,37,23,1610,60
308,1,6,11,37,23,1611,60
309,1,6,12,39,21,1612,60
310,1,6,13,40,20,1613,60
311,1,6,14,42,18,1614,60
312,1,6,15,43,17,1615,60
313,1,6,17,45,15,1617,60
314,1,6,18,49,11,1618,60
315,1,6,19,53,7,1619,60
316,1,6,20,55,5,1620,60
317,1,7,-16,4,56,17-16,60
318,1,7,-15,12,48,17-15,60
319,1,7,-14,11,49,17-14,60
320,1,7,-13,6,54,17-13,60
321,1,7,-12,8,52,17-12,60
322,1,7,-11,14,46,17-11,60
323,1,7,-10,13,47,17-10,60
324,1,7,-9,18,51,17-9,69
325,1,7,-8,23,60,17-8,83
326,1,7,-7,40,98,17-7,138
327,1,7,-6,41,134,17-6,175
328,1,7,-5,64,167,17-5,231
329,1,7,-4,63,174,17-4,237
330,1,7,-3,89,173,17-3,262
331,1,7,-2,97,190,17-2,287
332,1,7,-1,114,177,17-1,291
333,1,7,1,110,179,171,289
334,1,7,2,120,140,172,260
335,1,7,3,98,116,173,214
336,1,7,4,105,101,174,206
337,1,7,5,75,84,175,159
338,1,7,6,66,71,176,137
339,1,7,7,41,47,177,88
340,1,7,8,35,38,178,73
341,1,7,9,36,24,179,60
342,1,7,10,34,26,1710,60
343,1,7,11,38,22,1711,60
344,1,7,12,37,23,1712,60
345,1,7,13,42,18,1713,60
346,1,7,14,37,23,1714,60
347,1,7,15,46,14,1715,60
348,1,7,16,43,17,1716,60
349,1,7,17,45,15,1717,60
350,1,8,-16,7,53,18-16,60
351,1,8,-14,6,54,18-14,60
352,1,8,-13,8,52,18-13,60
353,1,8,-12,13,47,18-12,60
354,1,8,-11,11,49,18-11,60
355,1,8,-10,10,50,18-10,60
356,1,8,-9,11,49,18-9,60
357,1,8,-8,19,56,18-8,75
358,1,8,-7,32,82,18-7,114
359,1,8,-6,39,125,18-6,164
360,1,8,-5,69,130,18-5,199
361,1,8,-4,80,181,18-4,261
362,1,8,-3,92,179,18-3,271
363,1,8,-2,109,225,18-2,334
364,1,8,-1,114,220,18-1,334
365,1,8,1,133,178,181,311
366,1,8,2,128,170,182,298
367,1,8,3,112,109,183,221
368,1,8,4,87,108,184,195
369,1,8,5,75,98,185,173
370,1,8,6,50,62,186,112
371,1,8,7,42,47,187,89
372,1,8,8,26,34,188,60
373,1,8,9,38,22,189,60
374,1,8,10,44,16,1810,60
375,1,8,11,39,21,1811,60
376,1,8,12,39,21,1812,60
377,1,8,13,42,18,1813,60
378,1,8,14,36,24,1814,60
379,1,8,15,36,24,1815,60
380,1,8,16,47,13,1816,60
381,1,9,-12,11,49,19-12,60
382,1,9,-11,11,49,19-11,60
383,1,9,-10,10,50,19-10,60
384,1,9,-9,14,46,19-9,60
385,1,9,-8,21,39,19-8,60
386,1,9,-7,27,53,19-7,80
387,1,9,-6,41,96,19-6,137
388,1,9,-5,60,122,19-5,182
389,1,9,-4,70,175,19-4,245
390,1,9,-3,82,169,19-3,251
391,1,9,-2,125,267,19-2,392
392,1,9,-1,136,224,19-1,360
393,1,9,1,134,194,191,328
394,1,9,2,159,201,192,360
395,1,9,3,121,134,193,255
396,1,9,4,99,119,194,218
397,1,9,5,83,85,195,168
398,1,9,6,47,42,196,89
399,1,9,7,36,38,197,74
400,1,9,8,35,25,198,60
401,1,9,9,31,29,199,60
402,1,9,10,41,19,1910,60
403,1,9,11,41,19,1911,60
404,1,9,12,41,19,1912,60
405,1,10,-11,10,50,110-11,60
406,1,10,-10,16,44,110-10,60
407,1,10,-9,13,47,110-9,60
408,1,10,-8,16,44,110-8,60
409,1,10,-7,23,37,110-7,60
410,1,10,-6,27,52,110-6,79
411,1,10,-5,46,79,110-5,125
412,1,10,-4,88,181,110-4,269
413,1,10,-3,85,153,110-3,238
414,1,10,-2,160,308,110-2,468
415,1,10,-1,133,194,110-1,327
416,1,10,1,136,174,1101,310
417,1,10,2,158,237,1102,395
418,1,10,3,91,118,1103,209
419,1,10,4,78,125,1104,203
420,1,10,5,50,53,1105,103
421,1,10,6,31,30,1106,61
422,1,10,7,34,26,1107,60
423,1,10,8,31,29,1108,60
424,1,10,9,35,25,1109,60
425,1,11,-6,18,42,111-6,60
426,1,11,-5,21,39,111-5,60
427,1,11,-4,30,53,111-4,83
428,1,11,-3,65,101,111-3,166
429,1,11,-2,235,489,111-2,724
430,1,11,-1,76,130,111-1,206
431,1,11,1,74,119,1111,193
432,1,11,2,239,354,1112,593
433,1,11,3,76,79,1113,155
434,1,11,4,33,32,1114,65
435,1,11,5,28,32,1115,60
436,1,11,6,28,32,1116,60
437,2,0,-38,0,60,20-38,60
438,2,0,-37,0,60,20-37,60
439,2,0,-36,0,60,20-36,60
440,2,0,-34,0,60,20-34,60
441,2,0,-33,0,60,20-33,60
442,2,0,-32,0,60,20-32,60
443,2,0,-31,0,60,20-31,60
444,2,0,-30,0,60,20-30,60
445,2,0,-29,0,60,20-29,60
446,2,0,-28,0,60,20-28,60
447,2,0,-27,0,60,20-27,60
448,2,0,-26,3,57,20-26,60
449,2,0,-25,3,57,20-25,60
450,2,0,-24,2,58,20-24,60
451,2,0,-23,3,57,20-23,60
452,2,0,-22,2,58,20-22,60
453,2,0,-21,1,59,20-21,60
454,2,0,-20,1,59,20-20,60
455,2,0,-19,2,58,20-19,60
456,2,0,-18,6,62,20-18,68
457,2,0,-17,6,68,20-17,74
458,2,0,-16,8,98,20-16,106
459,2,0,-15,17,115,20-15,132
460,2,0,-14,10,121,20-14,131
461,2,0,-13,21,141,20-13,162
462,2,0,-12,15,146,20-12,161
463,2,0,-11,23,154,20-11,177
464,2,0,-10,29,178,20-10,207
465,2,0,-9,29,219,20-9,248
466,2,0,-8,42,216,20-8,258
467,2,0,-7,41,199,20-7,240
468,2,0,-6,71,212,20-6,283
469,2,0,-5,76,171,20-5,247
470,2,0,-4,87,189,20-4,276
471,2,0,-3,76,194,20-3,270
472,2,0,-2,95,195,20-2,290
473,2,0,-1,77,145,20-1,222
474,2,0,1,94,128,201,222
475,2,0,2,120,119,202,239
476,2,0,3,97,135,203,232
477,2,0,4,120,82,204,202
478,2,0,5,114,77,205,191
479,2,0,6,143,87,206,230
480,2,0,7,117,56,207,173
481,2,0,8,118,56,208,174
482,2,0,9,113,42,209,155
483,2,0,10,90,43,2010,133
484,2,0,11,69,34,2011,103
485,2,0,12,78,14,2012,92
486,2,0,13,65,9,2013,74
487,2,0,14,66,6,2014,72
488,2,0,15,46,14,2015,60
489,2,0,16,52,8,2016,60
490,2,0,17,51,9,2017,60
491,2,0,18,57,3,2018,60
492,2,0,19,55,5,2019,60
493,2,0,20,51,9,2020,60
494,2,0,21,54,6,2021,60
495,2,0,22,53,7,2022,60
496,2,0,23,52,8,2023,60
497,2,0,24,58,2,2024,60
498,2,0,25,58,2,2025,60
499,2,0,26,60,0,2026,60
500,2,0,27,58,2,2027,60
501,2,0,28,59,1,2028,60
502,2,0,29,60,0,2029,60
503,2,0,30,60,0,2030,60
504,2,0,31,60,0,2031,60
505,2,0,32,60,0,2032,60
506,2,0,33,60,0,2033,60
507,2,0,34,59,1,2034,60
508,2,0,39,60,0,2039,60
509,2,0,41,57,3,2041,60
510,2,1,-35,0,60,21-35,60
511,2,1,-34,0,60,21-34,60
512,2,1,-33,0,60,21-33,60
513,2,1,-32,0,60,21-32,60
514,2,1,-31,0,60,21-31,60
515,2,1,-30,0,60,21-30,60
516,2,1,-29,0,60,21-29,60
517,2,1,-28,0,60,21-28,60
518,2,1,-27,1,59,21-27,60
519,2,1,-26,4,56,21-26,60
520,2,1,-25,0,60,21-25,60
521,2,1,-24,2,58,21-24,60
522,2,1,-23,3,57,21-23,60
523,2,1,-22,3,57,21-22,60
524,2,1,-21,1,59,21-21,60
525,2,1,-20,1,59,21-20,60
526,2,1,-19,1,59,21-19,60
527,2,1,-18,3,57,21-18,60
528,2,1,-17,2,58,21-17,60
529,2,1,-16,5,63,21-16,68
530,2,1,-15,6,64,21-15,70
531,2,1,-14,7,65,21-14,72
532,2,1,-13,9,83,21-13,92
533,2,1,-12,14,88,21-12,102
534,2,1,-11,19,110,21-11,129
535,2,1,-10,21,114,21-10,135
536,2,1,-9,22,144,21-9,166
537,2,1,-8,33,126,21-8,159
538,2,1,-7,35,147,21-7,182
539,2,1,-6,42,141,21-6,183
540,2,1,-5,40,123,21-5,163
541,2,1,-4,51,128,21-4,179
542,2,1,-3,59,110,21-3,169
543,2,1,-2,69,120,21-2,189
544,2,1,-1,58,123,21-1,181
545,2,1,1,64,84,211,148
546,2,1,2,67,80,212,147
547,2,1,3,93,81,213,174
548,2,1,4,91,63,214,154
549,2,1,5,81,66,215,147
550,2,1,6,76,49,216,125
551,2,1,7,79,48,217,127
552,2,1,8,64,37,218,101
553,2,1,9,62,29,219,91
554,2,1,10,56,19,2110,75
555,2,1,11,52,10,2111,62
556,2,1,12,54,10,2112,64
557,2,1,13,53,9,2113,62
558,2,1,14,51,9,2114,60
559,2,1,15,54,6,2115,60
560,2,1,16,52,8,2116,60
561,2,1,17,50,10,2117,60
562,2,1,18,44,16,2118,60
563,2,1,19,56,4,2119,60
564,2,1,20,55,5,2120,60
565,2,1,21,58,2,2121,60
566,2,1,22,56,4,2122,60
567,2,1,23,59,1,2123,60
568,2,1,24,54,6,2124,60
569,2,1,25,55,5,2125,60
570,2,1,26,59,1,2126,60
571,2,1,27,59,1,2127,60
572,2,1,28,60,0,2128,60
573,2,1,29,60,0,2129,60
574,2,1,30,60,0,2130,60
575,2,1,33,60,0,2133,60
576,2,1,34,59,1,2134,60
577,2,1,41,59,1,2141,60
578,2,2,-32,0,60,22-32,60
579,2,2,-31,0,60,22-31,60
580,2,2,-30,0,60,22-30,60
581,2,2,-29,0,60,22-29,60
582,2,2,-28,0,60,22-28,60
583,2,2,-27,0,60,22-27,60
584,2,2,-26,2,58,22-26,60
585,2,2,-25,0,60,22-25,60
586,2,2,-24,2,58,22-24,60
587,2,2,-23,1,59,22-23,60
588,2,2,-22,0,60,22-22,60
589,2,2,-21,1,59,22-21,60
590,2,2,-20,2,58,22-20,60
591,2,2,-19,3,57,22-19,60
592,2,2,-18,6,54,22-18,60
593,2,2,-17,3,57,22-17,60
594,2,2,-16,8,52,22-16,60
595,2,2,-15,6,56,22-15,62
596,2,2,-14,8,82,22-14,90
597,2,2,-13,14,75,22-13,89
598,2,2,-12,12,102,22-12,114
599,2,2,-11,15,92,22-11,107
600,2,2,-10,22,110,22-10,132
601,2,2,-9,29,105,22-9,134
602,2,2,-8,32,127,22-8,159
603,2,2,-7,36,119,22-7,155
604,2,2,-6,51,135,22-6,186
605,2,2,-5,51,144,22-5,195
606,2,2,-4,47,129,22-4,176
607,2,2,-3,52,103,22-3,155
608,2,2,-2,65,110,22-2,175
609,2,2,-1,38,104,22-1,142
610,2,2,1,54,87,221,141
611,2,2,2,51,80,222,131
612,2,2,3,77,61,223,138
613,2,2,4,73,55,224,128
614,2,2,5,71,47,225,118
615,2,2,6,86,52,226,138
616,2,2,7,74,43,227,117
617,2,2,8,74,34,228,108
618,2,2,9,76,27,229,103
619,2,2,10,57,25,2210,82
620,2,2,11,50,19,2211,69
621,2,2,12,49,11,2212,60
622,2,2,13,49,11,2213,60
623,2,2,14,56,4,2214,60
624,2,2,15,51,9,2215,60
625,2,2,16,52,8,2216,60
626,2,2,17,54,6,2217,60
627,2,2,18,54,6,2218,60
628,2,2,19,54,6,2219,60
629,2,2,20,55,5,2220,60
630,2,2,21,53,7,2221,60
631,2,2,22,54,6,2222,60
632,2,2,23,56,4,2223,60
633,2,2,24,54,6,2224,60
634,2,2,25,56,4,2225,60
635,2,2,26,59,1,2226,60
636,2,2,27,59,1,2227,60
637,2,2,28,60,0,2228,60
638,2,2,29,60,0,2229,60
639,2,2,30,60,0,2230,60
640,2,2,37,59,1,2237,60
641,2,2,38,59,1,2238,60
642,2,2,39,57,3,2239,60
643,2,2,40,60,0,2240,60
644,2,3,-31,0,60,23-31,60
645,2,3,-30,0,60,23-30,60
646,2,3,-29,0,60,23-29,60
647,2,3,-28,1,59,23-28,60
648,2,3,-27,2,58,23-27,60
649,2,3,-26,1,59,23-26,60
650,2,3,-25,0,60,23-25,60
651,2,3,-24,3,57,23-24,60
652,2,3,-23,2,58,23-23,60
653,2,3,-22,3,57,23-22,60
654,2,3,-21,0,60,23-21,60
655,2,3,-20,1,59,23-20,60
656,2,3,-19,3,57,23-19,60
657,2,3,-18,1,59,23-18,60
658,2,3,-17,6,54,23-17,60
659,2,3,-16,3,57,23-16,60
660,2,3,-15,7,70,23-15,77
661,2,3,-14,9,79,23-14,88
662,2,3,-13,12,81,23-13,93
663,2,3,-12,13,110,23-12,123
664,2,3,-11,10,95,23-11,105
665,2,3,-10,22,109,23-10,131
666,2,3,-9,21,119,23-9,140
667,2,3,-8,41,123,23-8,164
668,2,3,-7,30,134,23-7,164
669,2,3,-6,31,128,23-6,159
670,2,3,-5,39,116,23-5,155
671,2,3,-4,56,136,23-4,192
672,2,3,-3,59,100,23-3,159
673,2,3,-2,68,109,23-2,177
674,2,3,-1,90,115,23-1,205
675,2,3,1,65,99,231,164
676,2,3,2,72,105,232,177
677,2,3,3,83,73,233,156
678,2,3,4,47,66,234,113
679,2,3,5,86,60,235,146
680,2,3,6,67,47,236,114
681,2,3,7,75,48,237,123
682,2,3,8,63,45,238,108
683,2,3,9,51,26,239,77
684,2,3,10,53,13,2310,66
685,2,3,11,43,17,2311,60
686,2,3,12,46,14,2312,60
687,2,3,13,45,15,2313,60
688,2,3,14,46,14,2314,60
689,2,3,15,48,12,2315,60
690,2,3,16,50,10,2316,60
691,2,3,17,53,7,2317,60
692,2,3,18,50,10,2318,60
693,2,3,19,55,5,2319,60
694,2,3,20,55,5,2320,60
695,2,3,21,55,5,2321,60
696,2,3,22,53,7,2322,60
697,2,3,23,51,9,2323,60
698,2,3,24,58,2,2324,60
699,2,3,25,56,4,2325,60
700,2,3,26,54,6,2326,60
701,2,3,27,60,0,2327,60
702,2,3,28,60,0,2328,60
703,2,3,37,60,0,2337,60
704,2,3,39,59,1,2339,60
705,2,4,-33,0,60,24-33,60
706,2,4,-31,0,60,24-31,60
707,2,4,-30,0,60,24-30,60
708,2,4,-29,0,60,24-29,60
709,2,4,-28,1,59,24-28,60
710,2,4,-27,0,60,24-27,60
711,2,4,-26,2,58,24-26,60
712,2,4,-25,2,58,24-25,60
713,2,4,-24,3,57,24-24,60
714,2,4,-23,2,58,24-23,60
715,2,4,-22,4,56,24-22,60
716,2,4,-21,3,57,24-21,60
717,2,4,-20,2,58,24-20,60
718,2,4,-19,3,57,24-19,60
719,2,4,-18,4,56,24-18,60
720,2,4,-17,5,55,24-17,60
721,2,4,-16,7,63,24-16,70
722,2,4,-15,12,55,24-15,67
723,2,4,-14,8,57,24-14,65
724,2,4,-13,15,66,24-13,81
725,2,4,-12,13,71,24-12,84
726,2,4,-11,18,92,24-11,110
727,2,4,-10,25,121,24-10,146
728,2,4,-9,23,121,24-9,144
729,2,4,-8,28,124,24-8,152
730,2,4,-7,18,119,24-7,137
731,2,4,-6,31,120,24-6,151
732,2,4,-5,30,115,24-5,145
733,2,4,-4,30,111,24-4,141
734,2,4,-3,51,92,24-3,143
735,2,4,-2,71,109,24-2,180
736,2,4,-1,68,108,24-1,176
737,2,4,1,91,88,241,179
738,2,4,2,69,88,242,157
739,2,4,3,93,82,243,175
740,2,4,4,55,85,244,140
741,2,4,5,70,71,245,141
742,2,4,6,56,58,246,114
743,2,4,7,74,44,247,118
744,2,4,8,60,33,248,93
745,2,4,9,46,33,249,79
746,2,4,10,52,19,2410,71
747,2,4,11,47,13,2411,60
748,2,4,12,49,11,2412,60
749,2,4,13,48,12,2413,60
750,2,4,14,48,12,2414,60
751,2,4,15,50,10,2415,60
752,2,4,16,50,10,2416,60
753,2,4,17,54,6,2417,60
754,2,4,18,52,8,2418,60
755,2,4,19,54,6,2419,60
756,2,4,20,53,7,2420,60
757,2,4,21,52,8,2421,60
758,2,4,22,49,11,2422,60
759,2,4,23,57,3,2423,60
760,2,4,24,59,1,2424,60
761,2,4,25,55,5,2425,60
762,2,4,35,59,1,2435,60
763,2,5,-32,0,60,25-32,60
764,2,5,-31,0,60,25-31,60
765,2,5,-30,0,60,25-30,60
766,2,5,-29,0,60,25-29,60
767,2,5,-28,0,60,25-28,60
768,2,5,-27,0,60,25-27,60
769,2,5,-26,0,60,25-26,60
770,2,5,-25,2,58,25-25,60
771,2,5,-24,1,59,25-24,60
772,2,5,-23,1,59,25-23,60
773,2,5,-22,1,59,25-22,60
774,2,5,-21,0,60,25-21,60
775,2,5,-20,3,57,25-20,60
776,2,5,-19,1,59,25-19,60
777,2,5,-18,5,55,25-18,60
778,2,5,-17,8,52,25-17,60
779,2,5,-16,9,51,25-16,60
780,2,5,-15,8,52,25-15,60
781,2,5,-14,4,56,25-14,60
782,2,5,-13,10,60,25-13,70
783,2,5,-12,15,77,25-12,92
784,2,5,-11,24,93,25-11,117
785,2,5,-10,22,89,25-10,111
786,2,5,-9,33,125,25-9,158
787,2,5,-8,31,120,25-8,151
788,2,5,-7,30,134,25-7,164
789,2,5,-6,30,136,25-6,166
790,2,5,-5,40,113,25-5,153
791,2,5,-4,31,132,25-4,163
792,2,5,-3,46,113,25-3,159
793,2,5,-2,53,107,25-2,160
794,2,5,-1,72,104,25-1,176
795,2,5,1,75,95,251,170
796,2,5,2,75,76,252,151
797,2,5,3,77,90,253,167
798,2,5,4,59,68,254,127
799,2,5,5,71,78,255,149
800,2,5,6,62,53,256,115
801,2,5,7,60,40,257,100
802,2,5,8,46,29,258,75
803,2,5,9,55,22,259,77
804,2,5,10,53,19,2510,72
805,2,5,11,46,17,2511,63
806,2,5,12,53,7,2512,60
807,2,5,13,49,11,2513,60
808,2,5,14,46,14,2514,60
809,2,5,15,50,10,2515,60
810,2,5,16,49,11,2516,60
811,2,5,17,52,8,2517,60
812,2,5,18,49,11,2518,60
813,2,5,19,53,7,2519,60
814,2,5,20,49,11,2520,60
815,2,5,21,57,3,2521,60
816,2,5,22,53,7,2522,60
817,2,5,23,59,1,2523,60
818,2,5,24,57,3,2524,60
819,2,5,26,58,2,2526,60
820,2,5,27,57,3,2527,60
821,2,5,28,60,0,2528,60
822,2,5,32,60,0,2532,60
823,2,6,-31,0,60,26-31,60
824,2,6,-30,0,60,26-30,60
825,2,6,-29,0,60,26-29,60
826,2,6,-28,0,60,26-28,60
827,2,6,-27,1,59,26-27,60
828,2,6,-26,1,59,26-26,60
829,2,6,-25,2,58,26-25,60
830,2,6,-24,1,59,26-24,60
831,2,6,-23,1,59,26-23,60
832,2,6,-22,1,59,26-22,60
833,2,6,-21,0,60,26-21,60
834,2,6,-20,4,56,26-20,60
835,2,6,-19,4,56,26-19,60
836,2,6,-18,6,54,26-18,60
837,2,6,-17,5,55,26-17,60
838,2,6,-16,6,54,26-16,60
839,2,6,-15,6,60,26-15,66
840,2,6,-14,9,54,26-14,63
841,2,6,-13,10,69,26-13,79
842,2,6,-12,20,78,26-12,98
843,2,6,-11,17,68,26-11,85
844,2,6,-10,27,86,26-10,113
845,2,6,-9,15,99,26-9,114
846,2,6,-8,31,107,26-8,138
847,2,6,-7,30,114,26-7,144
848,2,6,-6,30,131,26-6,161
849,2,6,-5,42,126,26-5,168
850,2,6,-4,43,123,26-4,166
851,2,6,-3,69,136,26-3,205
852,2,6,-2,81,105,26-2,186
853,2,6,-1,58,102,26-1,160
854,2,6,1,65,85,261,150
855,2,6,2,71,81,262,152
856,2,6,3,72,77,263,149
857,2,6,4,51,65,264,116
858,2,6,5,76,65,265,141
859,2,6,6,48,58,266,106
860,2,6,7,49,44,267,93
861,2,6,8,58,33,268,91
862,2,6,9,50,26,269,76
863,2,6,10,45,17,2610,62
864,2,6,11,46,14,2611,60
865,2,6,12,47,13,2612,60
866,2,6,13,48,12,2613,60
867,2,6,14,48,12,2614,60
868,2,6,15,52,8,2615,60
869,2,6,16,49,11,2616,60
870,2,6,17,55,5,2617,60
871,2,6,18,52,8,2618,60
872,2,6,19,56,4,2619,60
873,2,6,20,51,9,2620,60
874,2,6,21,52,8,2621,60
875,2,6,22,50,10,2622,60
876,2,6,23,53,7,2623,60
877,2,6,24,57,3,2624,60
878,2,6,25,58,2,2625,60
879,2,6,26,56,4,2626,60
880,2,6,27,56,4,2627,60
881,2,6,28,60,0,2628,60
882,2,6,29,59,1,2629,60
883,2,6,31,60,0,2631,60
884,2,7,-28,0,60,27-28,60
885,2,7,-26,0,60,27-26,60
886,2,7,-25,0,60,27-25,60
887,2,7,-24,3,57,27-24,60
888,2,7,-23,3,57,27-23,60
889,2,7,-22,3,57,27-22,60
890,2,7,-21,1,59,27-21,60
891,2,7,-20,3,57,27-20,60
892,2,7,-19,1,59,27-19,60
893,2,7,-18,5,55,27-18,60
894,2,7,-17,6,54,27-17,60
895,2,7,-16,3,57,27-16,60
896,2,7,-15,10,50,27-15,60
897,2,7,-14,8,55,27-14,63
898,2,7,-13,11,52,27-13,63
899,2,7,-12,14,58,27-12,72
900,2,7,-11,16,79,27-11,95
901,2,7,-10,21,84,27-10,105
902,2,7,-9,28,92,27-9,120
903,2,7,-8,40,114,27-8,154
904,2,7,-7,32,101,27-7,133
905,2,7,-6,35,153,27-6,188
906,2,7,-5,44,127,27-5,171
907,2,7,-4,53,130,27-4,183
908,2,7,-3,49,109,27-3,158
909,2,7,-2,51,110,27-2,161
910,2,7,-1,57,98,27-1,155
911,2,7,1,73,108,271,181
912,2,7,2,76,79,272,155
913,2,7,3,87,91,273,178
914,2,7,4,60,71,274,131
915,2,7,5,62,63,275,125
916,2,7,6,54,51,276,105
917,2,7,7,49,44,277,93
918,2,7,8,47,27,278,74
919,2,7,9,44,22,279,66
920,2,7,10,47,14,2710,61
921,2,7,11,52,14,2711,66
922,2,7,12,44,16,2712,60
923,2,7,13,45,15,2713,60
924,2,7,14,49,11,2714,60
925,2,7,15,50,10,2715,60
926,2,7,16,53,7,2716,60
927,2,7,17,49,11,2717,60
928,2,7,18,56,4,2718,60
929,2,7,19,53,7,2719,60
930,2,7,20,51,9,2720,60
931,2,7,21,51,9,2721,60
932,2,7,22,51,9,2722,60
933,2,7,23,54,6,2723,60
934,2,7,24,50,10,2724,60
935,2,7,25,55,5,2725,60
936,2,7,26,57,3,2726,60
937,2,7,28,59,1,2728,60
938,2,7,29,60,0,2729,60
939,2,8,-26,1,59,28-26,60
940,2,8,-25,0,60,28-25,60
941,2,8,-24,1,59,28-24,60
942,2,8,-23,1,59,28-23,60
943,2,8,-22,0,60,28-22,60
944,2,8,-21,3,57,28-21,60
945,2,8,-20,4,56,28-20,60
946,2,8,-19,5,55,28-19,60
947,2,8,-18,6,54,28-18,60
948,2,8,-17,3,57,28-17,60
949,2,8,-16,8,52,28-16,60
950,2,8,-15,7,57,28-15,64
951,2,8,-14,7,59,28-14,66
952,2,8,-13,15,59,28-13,74
953,2,8,-12,11,58,28-12,69
954,2,8,-11,14,66,28-11,80
955,2,8,-10,21,79,28-10,100
956,2,8,-9,20,80,28-9,100
957,2,8,-8,29,110,28-8,139
958,2,8,-7,44,93,28-7,137
959,2,8,-6,39,120,28-6,159
960,2,8,-5,39,111,28-5,150
961,2,8,-4,45,137,28-4,182
962,2,8,-3,42,117,28-3,159
963,2,8,-2,62,127,28-2,189
964,2,8,-1,52,105,28-1,157
965,2,8,1,80,96,281,176
966,2,8,2,68,78,282,146
967,2,8,3,68,91,283,159
968,2,8,4,61,52,284,113
969,2,8,5,57,62,285,119
970,2,8,6,62,49,286,111
971,2,8,7,41,37,287,78
972,2,8,8,62,37,288,99
973,2,8,9,42,28,289,70
974,2,8,10,37,30,2810,67
975,2,8,11,36,24,2811,60
976,2,8,12,49,11,2812,60
977,2,8,13,41,19,2813,60
978,2,8,14,49,11,2814,60
979,2,8,15,45,15,2815,60
980,2,8,16,48,12,2816,60
981,2,8,17,54,6,2817,60
982,2,8,18,57,3,2818,60
983,2,8,19,52,8,2819,60
984,2,8,20,54,6,2820,60
985,2,8,21,49,11,2821,60
986,2,8,22,51,9,2822,60
987,2,8,23,51,9,2823,60
988,2,8,24,58,2,2824,60
989,2,8,25,56,4,2825,60
990,2,8,26,57,3,2826,60
991,2,8,27,58,2,2827,60
992,2,9,-29,0,60,29-29,60
993,2,9,-27,1,59,29-27,60
994,2,9,-26,3,57,29-26,60
995,2,9,-25,1,59,29-25,60
996,2,9,-24,4,56,29-24,60
997,2,9,-23,1,59,29-23,60
998,2,9,-22,0,60,29-22,60
999,2,9,-21,0,60,29-21,60
1000,2,9,-20,2,58,29-20,60
1001,2,9,-19,4,56,29-19,60
1002,2,9,-18,3,57,29-18,60
1003,2,9,-17,5,55,29-17,60
1004,2,9,-16,6,54,29-16,60
1005,2,9,-15,7,53,29-15,60
1006,2,9,-14,8,52,29-14,60
1007,2,9,-13,13,57,29-13,70
1008,2,9,-12,17,57,29-12,74
1009,2,9,-11,18,79,29-11,97
1010,2,9,-10,16,93,29-10,109
1011,2,9,-9,21,98,29-9,119
1012,2,9,-8,19,100,29-8,119
1013,2,9,-7,34,110,29-7,144
1014,2,9,-6,40,128,29-6,168
1015,2,9,-5,49,101,29-5,150
1016,2,9,-4,50,132,29-4,182
1017,2,9,-3,53,132,29-3,185
1018,2,9,-2,60,111,29-2,171
1019,2,9,-1,72,103,29-1,175
1020,2,9,1,70,97,291,167
1021,2,9,2,74,87,292,161
1022,2,9,3,74,83,293,157
1023,2,9,4,72,77,294,149
1024,2,9,5,67,56,295,123
1025,2,9,6,66,49,296,115
1026,2,9,7,54,42,297,96
1027,2,9,8,54,40,298,94
1028,2,9,9,59,30,299,89
1029,2,9,10,38,25,2910,63
1030,2,9,11,44,16,2911,60
1031,2,9,12,43,17,2912,60
1032,2,9,13,48,12,2913,60
1033,2,9,14,46,14,2914,60
1034,2,9,15,46,14,2915,60
1035,2,9,16,53,7,2916,60
1036,2,9,17,52,8,2917,60
1037,2,9,18,56,4,2918,60
1038,2,9,19,49,11,2919,60
1039,2,9,20,56,4,2920,60
1040,2,9,21,52,8,2921,60
1041,2,9,22,53,7,2922,60
1042,2,9,23,54,6,2923,60
1043,2,9,24,53,7,2924,60
1044,2,9,26,55,5,2926,60
1045,2,10,-26,1,59,210-26,60
1046,2,10,-25,1,59,210-25,60
1047,2,10,-24,5,55,210-24,60
1048,2,10,-23,3,57,210-23,60
1049,2,10,-22,8,52,210-22,60
1050,2,10,-21,3,57,210-21,60
1051,2,10,-20,1,59,210-20,60
1052,2,10,-19,4,56,210-19,60
1053,2,10,-18,9,51,210-18,60
1054,2,10,-17,10,50,210-17,60
1055,2,10,-16,5,55,210-16,60
1056,2,10,-15,7,53,210-15,60
1057,2,10,-14,6,54,210-14,60
1058,2,10,-13,8,52,210-13,60
1059,2,10,-12,11,54,210-12,65
1060,2,10,-11,13,71,210-11,84
1061,2,10,-10,13,72,210-10,85
1062,2,10,-9,24,97,210-9,121
1063,2,10,-8,21,99,210-8,120
1064,2,10,-7,21,116,210-7,137
1065,2,10,-6,34,102,210-6,136
1066,2,10,-5,46,119,210-5,165
1067,2,10,-4,63,119,210-4,182
1068,2,10,-3,55,120,210-3,175
1069,2,10,-2,65,123,210-2,188
1070,2,10,-1,62,98,210-1,160
1071,2,10,1,72,92,2101,164
1072,2,10,2,67,88,2102,155
1073,2,10,3,59,82,2103,141
1074,2,10,4,58,64,2104,122
1075,2,10,5,71,52,2105,123
1076,2,10,6,59,44,2106,103
1077,2,10,7,55,52,2107,107
1078,2,10,8,51,40,2108,91
1079,2,10,9,53,42,2109,95
1080,2,10,10,41,27,21010,68
1081,2,10,11,37,23,21011,60
1082,2,10,12,42,19,21012,61
1083,2,10,13,43,17,21013,60
1084,2,10,14,41,19,21014,60
1085,2,10,15,51,9,21015,60
1086,2,10,16,52,8,21016,60
1087,2,10,17,51,9,21017,60
1088,2,10,18,55,5,21018,60
1089,2,10,19,50,10,21019,60
1090,2,10,20,55,5,21020,60
1091,2,10,21,56,4,21021,60
1092,2,10,22,56,4,21022,60
1093,2,10,23,57,3,21023,60
1094,2,10,24,52,8,21024,60
1095,2,11,-25,2,58,211-25,60
1096,2,11,-24,1,59,211-24,60
1097,2,11,-23,6,54,211-23,60
1098,2,11,-22,3,57,211-22,60
1099,2,11,-21,2,58,211-21,60
1100,2,11,-20,4,56,211-20,60
1101,2,11,-19,3,57,211-19,60
1102,2,11,-18,5,55,211-18,60
1103,2,11,-17,6,54,211-17,60
1104,2,11,-16,8,52,211-16,60
1105,2,11,-15,6,54,211-15,60
1106,2,11,-14,12,48,211-14,60
1107,2,11,-13,8,52,211-13,60
1108,2,11,-12,6,54,211-12,60
1109,2,11,-11,13,59,211-11,72
1110,2,11,-10,12,59,211-10,71
1111,2,11,-9,16,81,211-9,97
1112,2,11,-8,15,76,211-8,91
1113,2,11,-7,33,85,211-7,118
1114,2,11,-6,31,80,211-6,111
1115,2,11,-5,35,96,211-5,131
1116,2,11,-4,39,87,211-4,126
1117,2,11,-3,42,104,211-3,146
1118,2,11,-2,48,86,211-2,134
1119,2,11,-1,62,78,211-1,140
1120,2,11,1,53,69,2111,122
1121,2,11,2,51,62,2112,113
1122,2,11,3,56,70,2113,126
1123,2,11,4,59,50,2114,109
1124,2,11,5,54,67,2115,121
1125,2,11,6,66,33,2116,99
1126,2,11,7,62,41,2117,103
1127,2,11,8,55,30,2118,85
1128,2,11,9,38,22,2119,60
1129,2,11,10,40,20,21110,60
1130,2,11,11,35,25,21111,60
1131,2,11,12,38,22,21112,60
1132,2,11,13,41,19,21113,60
1133,2,11,14,44,16,21114,60
1134,2,11,15,48,12,21115,60
1135,2,11,16,51,9,21116,60
1136,2,11,17,48,12,21117,60
1137,2,11,18,53,7,21118,60
1138,2,11,19,58,2,21119,60
1139,2,11,20,56,4,21120,60
1140,2,11,21,52,8,21121,60
1141,2,11,22,53,7,21122,60
1142,2,11,23,52,8,21123,60
1143,2,11,24,54,6,21124,60
1144,2,11,25,58,2,21125,60
1145,2,12,-26,1,59,212-26,60
1146,2,12,-23,2,58,212-23,60
1147,2,12,-22,6,54,212-22,60
1148,2,12,-21,3,57,212-21,60
1149,2,12,-20,3,57,212-20,60
1150,2,12,-19,3,57,212-19,60
1151,2,12,-18,7,53,212-18,60
1152,2,12,-17,3,57,212-17,60
1153,2,12,-16,5,55,212-16,60
1154,2,12,-15,8,52,212-15,60
1155,2,12,-14,9,51,212-14,60
1156,2,12,-13,9,51,212-13,60
1157,2,12,-12,7,53,212-12,60
1158,2,12,-11,7,53,212-11,60
1159,2,12,-10,7,53,212-10,60
1160,2,12,-9,9,51,212-9,60
1161,2,12,-8,13,47,212-8,60
1162,2,12,-7,22,38,212-7,60
1163,2,12,-6,13,63,212-6,76
1164,2,12,-5,27,68,212-5,95
1165,2,12,-4,25,62,212-4,87
1166,2,12,-3,31,62,212-3,93
1167,2,12,-2,37,58,212-2,95
1168,2,12,-1,27,48,212-1,75
1169,2,12,1,31,50,2121,81
1170,2,12,2,31,47,2122,78
1171,2,12,3,34,41,2123,75
1172,2,12,4,34,29,2124,63
1173,2,12,5,31,30,2125,61
1174,2,12,6,34,26,2126,60
1175,2,12,7,37,23,2127,60
1176,2,12,8,38,22,2128,60
1177,2,12,9,36,24,2129,60
1178,2,12,10,38,22,21210,60
1179,2,12,11,40,20,21211,60
1180,2,12,12,44,16,21212,60
1181,2,12,13,41,19,21213,60
1182,2,12,14,46,14,21214,60
1183,2,12,15,45,15,21215,60
1184,2,12,16,52,8,21216,60
1185,2,12,17,46,14,21217,60
1186,2,12,18,52,8,21218,60
1187,2,12,19,50,10,21219,60
1188,2,12,20,55,5,21220,60
1189,2,12,21,53,7,21221,60
1190,2,12,22,55,5,21222,60
1191,2,12,23,55,5,21223,60
1192,3,0,-42,0,60,30-42,60
1193,3,0,-41,0,60,30-41,60
1194,3,0,-40,0,60,30-40,60
1195,3,0,-39,0,60,30-39,60
1196,3,0,-38,0,60,30-38,60
1197,3,0,-37,0,60,30-37,60
1198,3,0,-36,0,60,30-36,60
1199,3,0,-35,0,60,30-35,60
1200,3,0,-34,0,60,30-34,60
1201,3,0,-33,0,60,30-33,60
1202,3,0,-32,1,59,30-32,60
1203,3,0,-31,0,60,30-31,60
1204,3,0,-30,0,60,30-30,60
1205,3,0,-29,0,60,30-29,60
1206,3,0,-28,0,60,30-28,60
1207,3,0,-27,0,60,30-27,60
1208,3,0,-26,2,58,30-26,60
1209,3,0,-25,0,60,30-25,60
1210,3,0,-24,0,60,30-24,60
1211,3,0,-23,1,59,30-23,60
1212,3,0,-22,1,76,30-22,77
1213,3,0,-21,2,77,30-21,79
1214,3,0,-20,3,85,30-20,88
1215,3,0,-19,1,94,30-19,95
1216,3,0,-18,3,112,30-18,115
1217,3,0,-17,3,124,30-17,127
1218,3,0,-16,3,117,30-16,120
1219,3,0,-15,0,132,30-15,132
1220,3,0,-14,7,148,30-14,155
1221,3,0,-13,7,133,30-13,140
1222,3,0,-12,5,133,30-12,138
1223,3,0,-11,5,148,30-11,153
1224,3,0,-10,13,137,30-10,150
1225,3,0,-9,17,164,30-9,181
1226,3,0,-8,30,138,30-8,168
1227,3,0,-7,38,204,30-7,242
1228,3,0,-6,44,166,30-6,210
1229,3,0,-5,60,161,30-5,221
1230,3,0,-4,72,174,30-4,246
1231,3,0,-3,65,131,30-3,196
1232,3,0,-2,62,142,30-2,204
1233,3,0,-1,100,126,30-1,226
1234,3,0,1,103,103,301,206
1235,3,0,2,98,102,302,200
1236,3,0,3,108,80,303,188
1237,3,0,4,88,69,304,157
1238,3,0,5,94,57,305,151
1239,3,0,6,113,42,306,155
1240,3,0,7,113,34,307,147
1241,3,0,8,118,25,308,143
1242,3,0,9,97,24,309,121
1243,3,0,10,84,9,3010,93
1244,3,0,11,78,8,3011,86
1245,3,0,12,85,7,3012,92
1246,3,0,13,83,5,3013,88
1247,3,0,14,74,2,3014,76
1248,3,0,15,58,2,3015,60
1249,3,0,16,61,1,3016,62
1250,3,0,17,57,3,3017,60
1251,3,0,18,56,4,3018,60
1252,3,0,19,60,0,3019,60
1253,3,0,20,59,1,3020,60
1254,3,0,21,56,4,3021,60
1255,3,0,22,57,3,3022,60
1256,3,0,23,57,3,3023,60
1257,3,0,24,56,4,3024,60
1258,3,0,25,55,5,3025,60
1259,3,0,26,59,1,3026,60
1260,3,0,27,60,0,3027,60
1261,3,0,28,60,0,3028,60
1262,3,0,29,60,0,3029,60
1263,3,0,30,60,0,3030,60
1264,3,0,31,60,0,3031,60
1265,3,0,33,60,0,3033,60
1266,3,0,34,60,0,3034,60
1267,3,0,35,60,0,3035,60
1268,3,0,36,60,0,3036,60
1269,3,0,37,60,0,3037,60
1270,3,0,38,60,0,3038,60
1271,3,0,39,60,0,3039,60
1272,3,0,41,60,0,3041,60
1273,3,0,42,60,0,3042,60
1274,3,0,44,60,0,3044,60
1275,3,0,46,60,0,3046,60
1276,3,0,47,60,0,3047,60
1277,3,0,48,60,0,3048,60
1278,3,1,-41,0,60,31-41,60
1279,3,1,-40,0,60,31-40,60
1280,3,1,-39,0,60,31-39,60
1281,3,1,-38,0,60,31-38,60
1282,3,1,-37,0,60,31-37,60
1283,3,1,-36,0,60,31-36,60
1284,3,1,-35,0,60,31-35,60
1285,3,1,-34,0,60,31-34,60
1286,3,1,-33,0,60,31-33,60
1287,3,1,-32,0,60,31-32,60
1288,3,1,-31,1,59,31-31,60
1289,3,1,-30,0,60,31-30,60
1290,3,1,-29,1,59,31-29,60
1291,3,1,-28,0,60,31-28,60
1292,3,1,-27,2,58,31-27,60
1293,3,1,-26,2,58,31-26,60
1294,3,1,-25,2,58,31-25,60
1295,3,1,-24,3,57,31-24,60
1296,3,1,-23,0,60,31-23,60
1297,3,1,-22,2,58,31-22,60
1298,3,1,-21,4,56,31-21,60
1299,3,1,-20,1,59,31-20,60
1300,3,1,-19,0,70,31-19,70
1301,3,1,-18,4,68,31-18,72
1302,3,1,-17,4,78,31-17,82
1303,3,1,-16,3,75,31-16,78
1304,3,1,-15,1,87,31-15,88
1305,3,1,-14,2,90,31-14,92
1306,3,1,-13,2,105,31-13,107
1307,3,1,-12,4,91,31-12,95
1308,3,1,-11,5,109,31-11,114
1309,3,1,-10,8,104,31-10,112
1310,3,1,-9,12,81,31-9,93
1311,3,1,-8,18,99,31-8,117
1312,3,1,-7,36,125,31-7,161
1313,3,1,-6,33,114,31-6,147
1314,3,1,-5,50,115,31-5,165
1315,3,1,-4,24,91,31-4,115
1316,3,1,-3,37,91,31-3,128
1317,3,1,-2,41,97,31-2,138
1318,3,1,-1,46,91,31-1,137
1319,3,1,1,72,71,311,143
1320,3,1,2,68,68,312,136
1321,3,1,3,97,66,313,163
1322,3,1,4,82,50,314,132
1323,3,1,5,71,34,315,105
1324,3,1,6,47,35,316,82
1325,3,1,7,71,24,317,95
1326,3,1,8,67,19,318,86
1327,3,1,9,58,11,319,69
1328,3,1,10,59,9,3110,68
1329,3,1,11,53,7,3111,60
1330,3,1,12,55,5,3112,60
1331,3,1,13,55,5,3113,60
1332,3,1,14,57,3,3114,60
1333,3,1,15,57,3,3115,60
1334,3,1,16,59,1,3116,60
1335,3,1,17,59,1,3117,60
1336,3,1,18,58,2,3118,60
1337,3,1,19,59,1,3119,60
1338,3,1,20,58,2,3120,60
1339,3,1,21,59,1,3121,60
1340,3,1,22,56,4,3122,60
1341,3,1,23,58,2,3123,60
1342,3,1,24,57,3,3124,60
1343,3,1,25,58,2,3125,60
1344,3,1,26,58,2,3126,60
1345,3,1,27,60,0,3127,60
1346,3,1,28,60,0,3128,60
1347,3,1,29,60,0,3129,60
1348,3,1,30,60,0,3130,60
1349,3,1,31,60,0,3131,60
1350,3,1,32,59,1,3132,60
1351,3,1,33,60,0,3133,60
1352,3,1,34,60,0,3134,60
1353,3,1,35,60,0,3135,60
1354,3,1,46,60,0,3146,60
1355,3,1,49,60,0,3149,60
1356,3,2,-40,0,60,32-40,60
1357,3,2,-39,0,60,32-39,60
1358,3,2,-38,0,60,32-38,60
1359,3,2,-37,0,60,32-37,60
1360,3,2,-36,0,60,32-36,60
1361,3,2,-35,0,60,32-35,60
1362,3,2,-34,0,60,32-34,60
1363,3,2,-33,0,60,32-33,60
1364,3,2,-32,0,60,32-32,60
1365,3,2,-31,0,60,32-31,60
1366,3,2,-30,1,59,32-30,60
1367,3,2,-29,0,60,32-29,60
1368,3,2,-28,1,59,32-28,60
1369,3,2,-27,3,57,32-27,60
1370,3,2,-26,4,56,32-26,60
1371,3,2,-25,2,58,32-25,60
1372,3,2,-24,1,59,32-24,60
1373,3,2,-23,0,60,32-23,60
1374,3,2,-22,1,59,32-22,60
1375,3,2,-21,2,58,32-21,60
1376,3,2,-20,1,59,32-20,60
1377,3,2,-19,4,56,32-19,60
1378,3,2,-18,1,59,32-18,60
1379,3,2,-17,3,76,32-17,79
1380,3,2,-16,2,86,32-16,88
1381,3,2,-15,2,82,32-15,84
1382,3,2,-14,2,96,32-14,98
1383,3,2,-13,3,89,32-13,92
1384,3,2,-12,4,103,32-12,107
1385,3,2,-11,7,123,32-11,130
1386,3,2,-10,15,106,32-10,121
1387,3,2,-9,12,117,32-9,129
1388,3,2,-8,19,107,32-8,126
1389,3,2,-7,23,95,32-7,118
1390,3,2,-6,21,89,32-6,110
1391,3,2,-5,28,104,32-5,132
1392,3,2,-4,36,91,32-4,127
1393,3,2,-3,45,87,32-3,132
1394,3,2,-2,45,84,32-2,129
1395,3,2,-1,42,78,32-1,120
1396,3,2,1,58,79,321,137
1397,3,2,2,73,53,322,126
1398,3,2,3,73,57,323,130
1399,3,2,4,62,42,324,104
1400,3,2,5,70,47,325,117
1401,3,2,6,61,32,326,93
1402,3,2,7,68,32,327,100
1403,3,2,8,60,18,328,78
1404,3,2,9,54,14,329,68
1405,3,2,10,55,8,3210,63
1406,3,2,11,53,7,3211,60
1407,3,2,12,55,5,3212,60
1408,3,2,13,55,5,3213,60
1409,3,2,14,57,3,3214,60
1410,3,2,15,58,2,3215,60
1411,3,2,16,58,2,3216,60
1412,3,2,17,58,2,3217,60
1413,3,2,18,56,4,3218,60
1414,3,2,19,60,0,3219,60
1415,3,2,20,58,2,3220,60
1416,3,2,21,58,2,3221,60
1417,3,2,22,56,4,3222,60
1418,3,2,23,59,1,3223,60
1419,3,2,24,59,1,3224,60
1420,3,2,25,57,3,3225,60
1421,3,2,26,58,2,3226,60
1422,3,2,27,55,5,3227,60
1423,3,2,28,60,0,3228,60
1424,3,2,29,60,0,3229,60
1425,3,2,30,60,0,3230,60
1426,3,2,31,60,0,3231,60
1427,3,2,32,60,0,3232,60
1428,3,2,33,60,0,3233,60
1429,3,2,35,60,0,3235,60
1430,3,2,42,60,0,3242,60
1431,3,2,43,60,0,3243,60
1432,3,2,44,60,0,3244,60
1433,3,2,46,59,1,3246,60
1434,3,3,-41,0,60,33-41,60
1435,3,3,-40,0,60,33-40,60
1436,3,3,-39,0,60,33-39,60
1437,3,3,-38,0,60,33-38,60
1438,3,3,-37,0,60,33-37,60
1439,3,3,-36,0,60,33-36,60
1440,3,3,-35,0,60,33-35,60
1441,3,3,-34,0,60,33-34,60
1442,3,3,-33,0,60,33-33,60
1443,3,3,-32,1,59,33-32,60
1444,3,3,-31,0,60,33-31,60
1445,3,3,-30,0,60,33-30,60
1446,3,3,-29,1,59,33-29,60
1447,3,3,-28,0,60,33-28,60
1448,3,3,-27,1,59,33-27,60
1449,3,3,-26,1,59,33-26,60
1450,3,3,-25,2,58,33-25,60
1451,3,3,-24,1,59,33-24,60
1452,3,3,-23,3,57,33-23,60
1453,3,3,-22,2,58,33-22,60
1454,3,3,-21,1,59,33-21,60
1455,3,3,-20,2,58,33-20,60
1456,3,3,-19,2,58,33-19,60
1457,3,3,-18,1,59,33-18,60
1458,3,3,-17,0,60,33-17,60
1459,3,3,-16,1,74,33-16,75
1460,3,3,-15,2,79,33-15,81
1461,3,3,-14,3,96,33-14,99
1462,3,3,-13,6,112,33-13,118
1463,3,3,-12,11,103,33-12,114
1464,3,3,-11,17,105,33-11,122
1465,3,3,-10,17,97,33-10,114
1466,3,3,-9,15,104,33-9,119
1467,3,3,-8,19,107,33-8,126
1468,3,3,-7,25,107,33-7,132
1469,3,3,-6,25,105,33-6,130
1470,3,3,-5,26,98,33-5,124
1471,3,3,-4,43,92,33-4,135
1472,3,3,-3,34,98,33-3,132
1473,3,3,-2,47,99,33-2,146
1474,3,3,-1,58,81,33-1,139
1475,3,3,1,55,74,331,129
1476,3,3,2,53,62,332,115
1477,3,3,3,68,55,333,123
1478,3,3,4,77,35,334,112
1479,3,3,5,71,39,335,110
1480,3,3,6,72,30,336,102
1481,3,3,7,65,23,337,88
1482,3,3,8,60,23,338,83
1483,3,3,9,66,18,339,84
1484,3,3,10,49,11,3310,60
1485,3,3,11,61,5,3311,66
1486,3,3,12,58,5,3312,63
1487,3,3,13,57,3,3313,60
1488,3,3,14,55,5,3314,60
1489,3,3,15,58,2,3315,60
1490,3,3,16,55,5,3316,60
1491,3,3,17,57,3,3317,60
1492,3,3,18,58,2,3318,60
1493,3,3,19,60,0,3319,60
1494,3,3,20,58,2,3320,60
1495,3,3,21,57,3,3321,60
1496,3,3,22,56,4,3322,60
1497,3,3,23,59,1,3323,60
1498,3,3,24,57,3,3324,60
1499,3,3,25,56,4,3325,60
1500,3,3,26,57,3,3326,60
1501,3,3,27,59,1,3327,60
1502,3,3,28,60,0,3328,60
1503,3,3,29,60,0,3329,60
1504,3,3,30,60,0,3330,60
1505,3,3,32,60,0,3332,60
1506,3,3,33,60,0,3333,60
1507,3,3,34,60,0,3334,60
1508,3,3,35,60,0,3335,60
1509,3,3,36,59,1,3336,60
1510,3,3,40,60,0,3340,60
1511,3,3,41,59,1,3341,60
1512,3,3,42,59,1,3342,60
1513,3,3,43,59,1,3343,60
1514,3,3,44,60,0,3344,60
1515,3,3,45,60,0,3345,60
1516,3,4,-43,0,60,34-43,60
1517,3,4,-42,0,60,34-42,60
1518,3,4,-41,0,60,34-41,60
1519,3,4,-39,0,60,34-39,60
1520,3,4,-38,0,60,34-38,60
1521,3,4,-37,0,60,34-37,60
1522,3,4,-36,0,60,34-36,60
1523,3,4,-35,0,60,34-35,60
1524,3,4,-34,0,60,34-34,60
1525,3,4,-33,0,60,34-33,60
1526,3,4,-32,0,60,34-32,60
1527,3,4,-31,0,60,34-31,60
1528,3,4,-30,0,60,34-30,60
1529,3,4,-29,2,58,34-29,60
1530,3,4,-28,1,59,34-28,60
1531,3,4,-27,1,59,34-27,60
1532,3,4,-26,0,60,34-26,60
1533,3,4,-25,1,59,34-25,60
1534,3,4,-24,4,56,34-24,60
1535,3,4,-23,2,58,34-23,60
1536,3,4,-22,2,58,34-22,60
1537,3,4,-21,2,58,34-21,60
1538,3,4,-20,2,58,34-20,60
1539,3,4,-19,3,57,34-19,60
1540,3,4,-18,2,58,34-18,60
1541,3,4,-17,0,65,34-17,65
1542,3,4,-16,3,75,34-16,78
1543,3,4,-15,4,87,34-15,91
1544,3,4,-14,7,97,34-14,104
1545,3,4,-13,7,97,34-13,104
1546,3,4,-12,10,97,34-12,107
1547,3,4,-11,13,119,34-11,132
1548,3,4,-10,21,115,34-10,136
1549,3,4,-9,20,126,34-9,146
1550,3,4,-8,13,95,34-8,108
1551,3,4,-7,21,98,34-7,119
1552,3,4,-6,23,99,34-6,122
1553,3,4,-5,36,96,34-5,132
1554,3,4,-4,37,97,34-4,134
1555,3,4,-3,51,84,34-3,135
1556,3,4,-2,50,95,34-2,145
1557,3,4,-1,54,80,34-1,134
1558,3,4,1,65,70,341,135
1559,3,4,2,63,74,342,137
1560,3,4,3,66,48,343,114
1561,3,4,4,69,43,344,112
1562,3,4,5,59,38,345,97
1563,3,4,6,69,25,346,94
1564,3,4,7,61,29,347,90
1565,3,4,8,56,22,348,78
1566,3,4,9,63,16,349,79
1567,3,4,10,67,16,3410,83
1568,3,4,11,53,7,3411,60
1569,3,4,12,50,10,3412,60
1570,3,4,13,54,6,3413,60
1571,3,4,14,56,4,3414,60
1572,3,4,15,59,1,3415,60
1573,3,4,16,54,6,3416,60
1574,3,4,17,58,2,3417,60
1575,3,4,18,55,5,3418,60
1576,3,4,19,58,2,3419,60
1577,3,4,20,60,0,3420,60
1578,3,4,21,56,4,3421,60
1579,3,4,22,60,0,3422,60
1580,3,4,23,54,6,3423,60
1581,3,4,24,57,3,3424,60
1582,3,4,25,55,5,3425,60
1583,3,4,26,59,1,3426,60
1584,3,4,27,59,1,3427,60
1585,3,4,28,59,1,3428,60
1586,3,4,29,60,0,3429,60
1587,3,4,30,60,0,3430,60
1588,3,4,31,60,0,3431,60
1589,3,4,32,60,0,3432,60
1590,3,4,33,60,0,3433,60
1591,3,4,34,60,0,3434,60
1592,3,4,35,60,0,3435,60
1593,3,4,36,60,0,3436,60
1594,3,4,37,60,0,3437,60
1595,3,4,38,60,0,3438,60
1596,3,4,42,60,0,3442,60
1597,3,4,44,60,0,3444,60
1598,3,5,-38,0,60,35-38,60
1599,3,5,-37,0,60,35-37,60
1600,3,5,-36,0,60,35-36,60
1601,3,5,-35,0,60,35-35,60
1602,3,5,-34,0,60,35-34,60
1603,3,5,-33,0,60,35-33,60
1604,3,5,-32,1,59,35-32,60
1605,3,5,-31,0,60,35-31,60
1606,3,5,-30,0,60,35-30,60
1607,3,5,-29,2,58,35-29,60
1608,3,5,-28,1,59,35-28,60
1609,3,5,-27,1,59,35-27,60
1610,3,5,-26,3,57,35-26,60
1611,3,5,-25,2,58,35-25,60
1612,3,5,-24,1,59,35-24,60
1613,3,5,-23,1,59,35-23,60
1614,3,5,-22,1,59,35-22,60
1615,3,5,-21,1,59,35-21,60
1616,3,5,-20,1,59,35-20,60
1617,3,5,-19,1,59,35-19,60
1618,3,5,-18,3,57,35-18,60
1619,3,5,-17,5,64,35-17,69
1620,3,5,-16,3,63,35-16,66
1621,3,5,-15,3,90,35-15,93
1622,3,5,-14,5,88,35-14,93
1623,3,5,-13,8,91,35-13,99
1624,3,5,-12,16,106,35-12,122
1625,3,5,-11,16,99,35-11,115
1626,3,5,-10,11,120,35-10,131
1627,3,5,-9,13,122,35-9,135
1628,3,5,-8,18,112,35-8,130
1629,3,5,-7,26,98,35-7,124
1630,3,5,-6,39,92,35-6,131
1631,3,5,-5,46,93,35-5,139
1632,3,5,-4,32,113,35-4,145
1633,3,5,-3,48,101,35-3,149
1634,3,5,-2,38,80,35-2,118
1635,3,5,-1,61,91,35-1,152
1636,3,5,1,64,75,351,139
1637,3,5,2,66,64,352,130
1638,3,5,3,61,52,353,113
1639,3,5,4,64,51,354,115
1640,3,5,5,54,47,355,101
1641,3,5,6,58,36,356,94
1642,3,5,7,71,31,357,102
1643,3,5,8,54,29,358,83
1644,3,5,9,61,14,359,75
1645,3,5,10,42,19,3510,61
1646,3,5,11,49,11,3511,60
1647,3,5,12,54,6,3512,60
1648,3,5,13,53,7,3513,60
1649,3,5,14,55,5,3514,60
1650,3,5,15,57,3,3515,60
1651,3,5,16,54,6,3516,60
1652,3,5,17,55,5,3517,60
1653,3,5,18,57,3,3518,60
1654,3,5,19,58,2,3519,60
1655,3,5,20,57,3,3520,60
1656,3,5,21,56,4,3521,60
1657,3,5,22,55,5,3522,60
1658,3,5,23,59,1,3523,60
1659,3,5,24,56,4,3524,60
1660,3,5,25,56,4,3525,60
1661,3,5,26,60,0,3526,60
1662,3,5,27,57,3,3527,60
1663,3,5,28,60,0,3528,60
1664,3,5,29,60,0,3529,60
1665,3,5,30,60,0,3530,60
1666,3,5,31,60,0,3531,60
1667,3,5,32,60,0,3532,60
1668,3,5,33,60,0,3533,60
1669,3,5,34,60,0,3534,60
1670,3,5,35,60,0,3535,60
1671,3,5,36,60,0,3536,60
1672,3,5,46,60,0,3546,60
1673,3,6,-37,0,60,36-37,60
1674,3,6,-36,0,60,36-36,60
1675,3,6,-35,0,60,36-35,60
1676,3,6,-34,0,60,36-34,60
1677,3,6,-33,0,60,36-33,60
1678,3,6,-32,0,60,36-32,60
1679,3,6,-31,1,59,36-31,60
1680,3,6,-30,1,59,36-30,60
1681,3,6,-29,2,58,36-29,60
1682,3,6,-28,0,60,36-28,60
1683,3,6,-27,1,59,36-27,60
1684,3,6,-26,3,57,36-26,60
1685,3,6,-25,2,58,36-25,60
1686,3,6,-24,3,57,36-24,60
1687,3,6,-23,2,58,36-23,60
1688,3,6,-22,1,59,36-22,60
1689,3,6,-21,2,58,36-21,60
1690,3,6,-20,2,58,36-20,60
1691,3,6,-19,1,59,36-19,60
1692,3,6,-18,2,58,36-18,60
1693,3,6,-17,2,58,36-17,60
1694,3,6,-16,4,56,36-16,60
1695,3,6,-15,8,61,36-15,69
1696,3,6,-14,6,81,36-14,87
1697,3,6,-13,7,82,36-13,89
1698,3,6,-12,8,92,36-12,100
1699,3,6,-11,8,114,36-11,122
1700,3,6,-10,17,104,36-10,121
1701,3,6,-9,18,113,36-9,131
1702,3,6,-8,24,119,36-8,143
1703,3,6,-7,27,89,36-7,116
1704,3,6,-6,34,103,36-6,137
1705,3,6,-5,34,90,36-5,124
1706,3,6,-4,29,90,36-4,119
1707,3,6,-3,49,79,36-3,128
1708,3,6,-2,43,85,36-2,128
1709,3,6,-1,58,76,36-1,134
1710,3,6,1,56,81,361,137
1711,3,6,2,57,61,362,118
1712,3,6,3,62,51,363,113
1713,3,6,4,53,44,364,97
1714,3,6,5,65,35,365,100
1715,3,6,6,61,29,366,90
1716,3,6,7,58,30,367,88
1717,3,6,8,55,33,368,88
1718,3,6,9,48,19,369,67
1719,3,6,10,50,14,3610,64
1720,3,6,11,52,8,3611,60
1721,3,6,12,52,8,3612,60
1722,3,6,13,55,5,3613,60
1723,3,6,14,53,7,3614,60
1724,3,6,15,54,6,3615,60
1725,3,6,16,56,4,3616,60
1726,3,6,17,57,3,3617,60
1727,3,6,18,55,5,3618,60
1728,3,6,19,56,4,3619,60
1729,3,6,20,54,6,3620,60
1730,3,6,21,58,2,3621,60
1731,3,6,22,57,3,3622,60
1732,3,6,23,55,5,3623,60
1733,3,6,24,57,3,3624,60
1734,3,6,25,56,4,3625,60
1735,3,6,26,59,1,3626,60
1736,3,6,27,55,5,3627,60
1737,3,6,28,60,0,3628,60
1738,3,6,29,60,0,3629,60
1739,3,6,31,60,0,3631,60
1740,3,6,32,60,0,3632,60
1741,3,6,33,60,0,3633,60
1742,3,6,34,60,0,3634,60
1743,3,6,35,60,0,3635,60
1744,3,6,42,60,0,3642,60
1745,3,6,43,60,0,3643,60
1746,3,6,44,59,1,3644,60
1747,3,7,-37,0,60,37-37,60
1748,3,7,-36,0,60,37-36,60
1749,3,7,-35,0,60,37-35,60
1750,3,7,-34,0,60,37-34,60
1751,3,7,-33,0,60,37-33,60
1752,3,7,-32,2,58,37-32,60
1753,3,7,-31,1,59,37-31,60
1754,3,7,-30,2,58,37-30,60
1755,3,7,-29,2,58,37-29,60
1756,3,7,-28,1,59,37-28,60
1757,3,7,-27,4,56,37-27,60
1758,3,7,-26,3,57,37-26,60
1759,3,7,-25,1,59,37-25,60
1760,3,7,-24,0,60,37-24,60
1761,3,7,-23,3,57,37-23,60
1762,3,7,-22,0,60,37-22,60
1763,3,7,-21,1,59,37-21,60
1764,3,7,-20,3,57,37-20,60
1765,3,7,-19,1,59,37-19,60
1766,3,7,-18,0,60,37-18,60
1767,3,7,-17,4,56,37-17,60
1768,3,7,-16,2,73,37-16,75
1769,3,7,-15,6,63,37-15,69
1770,3,7,-14,2,84,37-14,86
1771,3,7,-13,9,83,37-13,92
1772,3,7,-12,10,97,37-12,107
1773,3,7,-11,15,110,37-11,125
1774,3,7,-10,20,112,37-10,132
1775,3,7,-9,24,124,37-9,148
1776,3,7,-8,23,120,37-8,143
1777,3,7,-7,27,96,37-7,123
1778,3,7,-6,31,105,37-6,136
1779,3,7,-5,28,90,37-5,118
1780,3,7,-4,32,85,37-4,117
1781,3,7,-3,40,96,37-3,136
1782,3,7,-2,45,85,37-2,130
1783,3,7,-1,57,79,37-1,136
1784,3,7,1,72,68,371,140
1785,3,7,2,68,53,372,121
1786,3,7,3,74,55,373,129
1787,3,7,4,53,39,374,92
1788,3,7,5,79,38,375,117
1789,3,7,6,48,36,376,84
1790,3,7,7,58,31,377,89
1791,3,7,8,53,20,378,73
1792,3,7,9,56,22,379,78
1793,3,7,10,50,10,3710,60
1794,3,7,11,51,9,3711,60
1795,3,7,12,51,9,3712,60
1796,3,7,13,52,8,3713,60
1797,3,7,14,49,11,3714,60
1798,3,7,15,58,2,3715,60
1799,3,7,16,57,3,3716,60
1800,3,7,17,56,4,3717,60
1801,3,7,18,55,5,3718,60
1802,3,7,19,58,2,3719,60
1803,3,7,20,57,3,3720,60
1804,3,7,21,54,6,3721,60
1805,3,7,22,58,2,3722,60
1806,3,7,23,58,2,3723,60
1807,3,7,24,56,4,3724,60
1808,3,7,25,56,4,3725,60
1809,3,7,26,59,1,3726,60
1810,3,7,27,59,1,3727,60
1811,3,7,28,60,0,3728,60
1812,3,7,29,60,0,3729,60
1813,3,7,30,60,0,3730,60
1814,3,7,31,60,0,3731,60
1815,3,7,32,60,0,3732,60
1816,3,7,33,60,0,3733,60
1817,3,7,34,60,0,3734,60
1818,3,7,35,60,0,3735,60
1819,3,7,36,60,0,3736,60
1820,3,7,41,60,0,3741,60
1821,3,7,44,59,1,3744,60
1822,3,8,-40,0,60,38-40,60
1823,3,8,-39,0,60,38-39,60
1824,3,8,-38,0,60,38-38,60
1825,3,8,-37,0,60,38-37,60
1826,3,8,-36,0,60,38-36,60
1827,3,8,-35,0,60,38-35,60
1828,3,8,-34,0,60,38-34,60
1829,3,8,-33,0,60,38-33,60
1830,3,8,-32,1,59,38-32,60
1831,3,8,-31,0,60,38-31,60
1832,3,8,-30,0,60,38-30,60
1833,3,8,-29,0,60,38-29,60
1834,3,8,-28,1,59,38-28,60
1835,3,8,-27,2,58,38-27,60
1836,3,8,-26,2,58,38-26,60
1837,3,8,-25,5,55,38-25,60
1838,3,8,-24,3,57,38-24,60
1839,3,8,-23,2,58,38-23,60
1840,3,8,-22,0,60,38-22,60
1841,3,8,-21,1,59,38-21,60
1842,3,8,-20,1,59,38-20,60
1843,3,8,-19,1,59,38-19,60
1844,3,8,-18,4,56,38-18,60
1845,3,8,-17,4,56,38-17,60
1846,3,8,-16,3,69,38-16,72
1847,3,8,-15,2,62,38-15,64
1848,3,8,-14,5,83,38-14,88
1849,3,8,-13,6,82,38-13,88
1850,3,8,-12,7,94,38-12,101
1851,3,8,-11,13,93,38-11,106
1852,3,8,-10,22,102,38-10,124
1853,3,8,-9,21,102,38-9,123
1854,3,8,-8,25,134,38-8,159
1855,3,8,-7,28,110,38-7,138
1856,3,8,-6,27,108,38-6,135
1857,3,8,-5,37,107,38-5,144
1858,3,8,-4,44,106,38-4,150
1859,3,8,-3,39,105,38-3,144
1860,3,8,-2,53,98,38-2,151
1861,3,8,-1,43,87,38-1,130
1862,3,8,1,62,73,381,135
1863,3,8,2,69,61,382,130
1864,3,8,3,89,52,383,141
1865,3,8,4,73,33,384,106
1866,3,8,5,60,46,385,106
1867,3,8,6,64,31,386,95
1868,3,8,7,50,27,387,77
1869,3,8,8,58,29,388,87
1870,3,8,9,55,19,389,74
1871,3,8,10,55,19,3810,74
1872,3,8,11,46,14,3811,60
1873,3,8,12,52,8,3812,60
1874,3,8,13,51,9,3813,60
1875,3,8,14,57,3,3814,60
1876,3,8,15,55,5,3815,60
1877,3,8,16,55,5,3816,60
1878,3,8,17,57,3,3817,60
1879,3,8,18,57,3,3818,60
1880,3,8,19,57,3,3819,60
1881,3,8,20,56,4,3820,60
1882,3,8,21,58,2,3821,60
1883,3,8,22,59,1,3822,60
1884,3,8,23,57,3,3823,60
1885,3,8,24,51,9,3824,60
1886,3,8,25,56,4,3825,60
1887,3,8,26,57,3,3826,60
1888,3,8,27,59,1,3827,60
1889,3,8,28,60,0,3828,60
1890,3,8,29,60,0,3829,60
1891,3,8,30,60,0,3830,60
1892,3,8,31,60,0,3831,60
1893,3,8,35,60,0,3835,60
1894,3,8,36,60,0,3836,60
1895,3,8,37,60,0,3837,60
1896,3,8,38,60,0,3838,60
1897,3,8,41,60,0,3841,60
1898,3,8,42,60,0,3842,60
1899,3,9,-41,0,60,39-41,60
1900,3,9,-38,0,60,39-38,60
1901,3,9,-36,0,60,39-36,60
1902,3,9,-35,0,60,39-35,60
1903,3,9,-34,0,60,39-34,60
1904,3,9,-33,0,60,39-33,60
1905,3,9,-32,1,59,39-32,60
1906,3,9,-31,1,59,39-31,60
1907,3,9,-30,1,59,39-30,60
1908,3,9,-29,0,60,39-29,60
1909,3,9,-28,0,60,39-28,60
1910,3,9,-27,3,57,39-27,60
1911,3,9,-26,2,58,39-26,60
1912,3,9,-25,3,57,39-25,60
1913,3,9,-24,1,59,39-24,60
1914,3,9,-23,2,58,39-23,60
1915,3,9,-22,5,55,39-22,60
1916,3,9,-21,1,59,39-21,60
1917,3,9,-20,3,57,39-20,60
1918,3,9,-19,2,58,39-19,60
1919,3,9,-18,3,57,39-18,60
1920,3,9,-17,3,57,39-17,60
1921,3,9,-16,3,64,39-16,67
1922,3,9,-15,11,72,39-15,83
1923,3,9,-14,9,69,39-14,78
1924,3,9,-13,7,72,39-13,79
1925,3,9,-12,13,99,39-12,112
1926,3,9,-11,9,101,39-11,110
1927,3,9,-10,13,121,39-10,134
1928,3,9,-9,18,105,39-9,123
1929,3,9,-8,26,120,39-8,146
1930,3,9,-7,28,106,39-7,134
1931,3,9,-6,31,113,39-6,144
1932,3,9,-5,28,96,39-5,124
1933,3,9,-4,35,92,39-4,127
1934,3,9,-3,45,79,39-3,124
1935,3,9,-2,55,82,39-2,137
1936,3,9,-1,52,76,39-1,128
1937,3,9,1,69,62,391,131
1938,3,9,2,61,54,392,115
1939,3,9,3,66,61,393,127
1940,3,9,4,57,36,394,93
1941,3,9,5,81,40,395,121
1942,3,9,6,59,41,396,100
1943,3,9,7,53,30,397,83
1944,3,9,8,51,27,398,78
1945,3,9,9,48,12,399,60
1946,3,9,10,47,15,3910,62
1947,3,9,11,49,11,3911,60
1948,3,9,12,48,12,3912,60
1949,3,9,13,51,9,3913,60
1950,3,9,14,56,4,3914,60
1951,3,9,15,53,7,3915,60
1952,3,9,16,53,7,3916,60
1953,3,9,17,55,5,3917,60
1954,3,9,18,53,7,3918,60
1955,3,9,19,58,2,3919,60
1956,3,9,20,55,5,3920,60
1957,3,9,21,54,6,3921,60
1958,3,9,22,53,7,3922,60
1959,3,9,23,58,2,3923,60
1960,3,9,24,56,4,3924,60
1961,3,9,25,57,3,3925,60
1962,3,9,26,58,2,3926,60
1963,3,9,27,58,2,3927,60
1964,3,9,28,60,0,3928,60
1965,3,9,29,60,0,3929,60
1966,3,9,31,60,0,3931,60
1967,3,9,32,60,0,3932,60
1968,3,9,33,60,0,3933,60
1969,3,9,34,60,0,3934,60
1970,3,9,35,60,0,3935,60
1971,3,9,37,60,0,3937,60
1972,3,9,38,60,0,3938,60
1973,3,9,39,60,0,3939,60
1974,3,9,41,60,0,3941,60
1975,3,10,-38,0,60,310-38,60
1976,3,10,-37,0,60,310-37,60
1977,3,10,-35,0,60,310-35,60
1978,3,10,-34,0,60,310-34,60
1979,3,10,-33,0,60,310-33,60
1980,3,10,-32,0,60,310-32,60
1981,3,10,-31,0,60,310-31,60
1982,3,10,-30,1,59,310-30,60
1983,3,10,-29,0,60,310-29,60
1984,3,10,-28,0,60,310-28,60
1985,3,10,-27,1,59,310-27,60
1986,3,10,-26,1,59,310-26,60
1987,3,10,-25,0,60,310-25,60
1988,3,10,-24,3,57,310-24,60
1989,3,10,-23,1,59,310-23,60
1990,3,10,-22,2,58,310-22,60
1991,3,10,-21,4,56,310-21,60
1992,3,10,-20,2,58,310-20,60
1993,3,10,-19,3,57,310-19,60
1994,3,10,-18,7,53,310-18,60
1995,3,10,-17,6,54,310-17,60
1996,3,10,-16,4,56,310-16,60
1997,3,10,-15,3,57,310-15,60
1998,3,10,-14,4,76,310-14,80
1999,3,10,-13,2,74,310-13,76
2000,3,10,-12,8,80,310-12,88
2001,3,10,-11,5,92,310-11,97
2002,3,10,-10,17,90,310-10,107
2003,3,10,-9,17,106,310-9,123
2004,3,10,-8,18,116,310-8,134
2005,3,10,-7,28,113,310-7,141
2006,3,10,-6,31,101,310-6,132
2007,3,10,-5,29,103,310-5,132
2008,3,10,-4,40,90,310-4,130
2009,3,10,-3,39,90,310-3,129
2010,3,10,-2,46,85,310-2,131
2011,3,10,-1,59,79,310-1,138
2012,3,10,1,69,67,3101,136
2013,3,10,2,63,73,3102,136
2014,3,10,3,62,53,3103,115
2015,3,10,4,61,49,3104,110
2016,3,10,5,43,41,3105,84
2017,3,10,6,60,29,3106,89
2018,3,10,7,45,28,3107,73
2019,3,10,8,47,20,3108,67
2020,3,10,9,37,26,3109,63
2021,3,10,10,40,20,31010,60
2022,3,10,11,46,14,31011,60
2023,3,10,12,48,12,31012,60
2024,3,10,13,52,8,31013,60
2025,3,10,14,60,0,31014,60
2026,3,10,15,52,8,31015,60
2027,3,10,16,57,3,31016,60
2028,3,10,17,58,2,31017,60
2029,3,10,18,54,6,31018,60
2030,3,10,19,54,6,31019,60
2031,3,10,20,58,2,31020,60
2032,3,10,21,55,5,31021,60
2033,3,10,22,55,5,31022,60
2034,3,10,23,57,3,31023,60
2035,3,10,24,57,3,31024,60
2036,3,10,25,57,3,31025,60
2037,3,10,26,58,2,31026,60
2038,3,10,27,57,3,31027,60
2039,3,10,28,59,1,31028,60
2040,3,10,29,60,0,31029,60
2041,3,10,30,60,0,31030,60
2042,3,10,31,60,0,31031,60
2043,3,10,32,60,0,31032,60
2044,3,10,33,60,0,31033,60
2045,3,10,35,60,0,31035,60
2046,3,10,41,59,1,31041,60
2047,3,10,42,60,0,31042,60
2048,3,10,43,60,0,31043,60
2049,3,11,-38,0,60,311-38,60
2050,3,11,-37,0,60,311-37,60
2051,3,11,-36,0,60,311-36,60
2052,3,11,-35,0,60,311-35,60
2053,3,11,-34,0,60,311-34,60
2054,3,11,-33,0,60,311-33,60
2055,3,11,-32,0,60,311-32,60
2056,3,11,-31,0,60,311-31,60
2057,3,11,-30,1,59,311-30,60
2058,3,11,-29,1,59,311-29,60
2059,3,11,-28,2,58,311-28,60
2060,3,11,-27,1,59,311-27,60
2061,3,11,-26,1,59,311-26,60
2062,3,11,-25,1,59,311-25,60
2063,3,11,-24,3,57,311-24,60
2064,3,11,-23,2,58,311-23,60
2065,3,11,-22,4,56,311-22,60
2066,3,11,-21,4,56,311-21,60
2067,3,11,-20,0,60,311-20,60
2068,3,11,-19,3,57,311-19,60
2069,3,11,-18,3,57,311-18,60
2070,3,11,-17,5,55,311-17,60
2071,3,11,-16,7,53,311-16,60
2072,3,11,-15,1,59,311-15,60
2073,3,11,-14,5,55,311-14,60
2074,3,11,-13,6,74,311-13,80
2075,3,11,-12,6,66,311-12,72
2076,3,11,-11,7,76,311-11,83
2077,3,11,-10,7,91,311-10,98
2078,3,11,-9,18,84,311-9,102
2079,3,11,-8,17,94,311-8,111
2080,3,11,-7,22,86,311-7,108
2081,3,11,-6,28,87,311-6,115
2082,3,11,-5,34,80,311-5,114
2083,3,11,-4,29,80,311-4,109
2084,3,11,-3,33,69,311-3,102
2085,3,11,-2,43,53,311-2,96
2086,3,11,-1,40,56,311-1,96
2087,3,11,1,37,58,3111,95
2088,3,11,2,57,55,3112,112
2089,3,11,3,60,53,3113,113
2090,3,11,4,63,34,3114,97
2091,3,11,5,48,26,3115,74
2092,3,11,6,39,27,3116,66
2093,3,11,7,42,22,3117,64
2094,3,11,8,41,21,3118,62
2095,3,11,9,41,19,3119,60
2096,3,11,10,45,15,31110,60
2097,3,11,11,49,11,31111,60
2098,3,11,12,53,7,31112,60
2099,3,11,13,55,5,31113,60
2100,3,11,14,53,7,31114,60
2101,3,11,15,58,2,31115,60
2102,3,11,16,54,6,31116,60
2103,3,11,17,55,5,31117,60
2104,3,11,18,55,5,31118,60
2105,3,11,19,58,2,31119,60
2106,3,11,20,57,3,31120,60
2107,3,11,21,57,3,31121,60
2108,3,11,22,56,4,31122,60
2109,3,11,23,57,3,31123,60
2110,3,11,24,58,2,31124,60
2111,3,11,25,56,4,31125,60
2112,3,11,26,59,1,31126,60
2113,3,11,27,57,3,31127,60
2114,3,11,28,60,0,31128,60
2115,3,11,29,60,0,31129,60
2116,3,11,30,60,0,31130,60
2117,3,11,31,60,0,31131,60
2118,3,11,32,60,0,31132,60
2119,3,11,33,60,0,31133,60
2120,3,11,41,60,0,31141,60
2121,3,11,44,60,0,31144,60
2122,3,12,-36,0,60,312-36,60
2123,3,12,-34,0,60,312-34,60
2124,3,12,-33,0,60,312-33,60
2125,3,12,-32,0,60,312-32,60
2126,3,12,-31,1,59,312-31,60
2127,3,12,-30,1,59,312-30,60
2128,3,12,-29,1,59,312-29,60
2129,3,12,-28,1,59,312-28,60
2130,3,12,-27,1,59,312-27,60
2131,3,12,-26,0,60,312-26,60
2132,3,12,-25,3,57,312-25,60
2133,3,12,-24,0,60,312-24,60
2134,3,12,-23,2,58,312-23,60
2135,3,12,-22,1,59,312-22,60
2136,3,12,-21,3,57,312-21,60
2137,3,12,-20,3,57,312-20,60
2138,3,12,-19,2,58,312-19,60
2139,3,12,-18,1,59,312-18,60
2140,3,12,-17,3,57,312-17,60
2141,3,12,-16,4,56,312-16,60
2142,3,12,-15,5,55,312-15,60
2143,3,12,-14,0,60,312-14,60
2144,3,12,-13,6,54,312-13,60
2145,3,12,-12,7,53,312-12,60
2146,3,12,-11,9,51,312-11,60
2147,3,12,-10,10,50,312-10,60
2148,3,12,-9,5,55,312-9,60
2149,3,12,-8,10,58,312-8,68
2150,3,12,-7,11,52,312-7,63
2151,3,12,-6,17,64,312-6,81
2152,3,12,-5,23,37,312-5,60
2153,3,12,-4,22,42,312-4,64
2154,3,12,-3,20,53,312-3,73
2155,3,12,-2,29,52,312-2,81
2156,3,12,-1,25,35,312-1,60
2157,3,12,1,25,35,3121,60
2158,3,12,2,35,31,3122,66
2159,3,12,3,25,35,3123,60
2160,3,12,4,39,21,3124,60
2161,3,12,5,37,23,3125,60
2162,3,12,6,42,26,3126,68
2163,3,12,7,41,19,3127,60
2164,3,12,8,41,19,3128,60
2165,3,12,9,48,12,3129,60
2166,3,12,10,48,12,31210,60
2167,3,12,11,46,14,31211,60
2168,3,12,12,48,12,31212,60
2169,3,12,13,55,5,31213,60
2170,3,12,14,57,3,31214,60
2171,3,12,15,51,9,31215,60
2172,3,12,16,55,5,31216,60
2173,3,12,17,53,7,31217,60
2174,3,12,18,56,4,31218,60
2175,3,12,19,55,5,31219,60
2176,3,12,20,57,3,31220,60
2177,3,12,21,58,2,31221,60
2178,3,12,22,55,5,31222,60
2179,3,12,24,56,4,31224,60
2180,3,12,25,57,3,31225,60
2181,3,12,27,59,1,31227,60
2182,3,12,28,60,0,31228,60
2183,3,12,29,60,0,31229,60
2184,3,12,30,60,0,31230,60
2185,3,12,32,60,0,31232,60
2186,3,12,41,60,0,31241,60
2187,4,0,-46,0,60,40-46,60
2188,4,0,-45,0,60,40-45,60
2189,4,0,-44,0,60,40-44,60
2190,4,0,-43,0,60,40-43,60
2191,4,0,-42,0,60,40-42,60
2192,4,0,-41,0,60,40-41,60
2193,4,0,-40,0,60,40-40,60
2194,4,0,-39,0,60,40-39,60
2195,4,0,-38,0,60,40-38,60
2196,4,0,-37,0,60,40-37,60
2197,4,0,-36,0,60,40-36,60
2198,4,0,-35,0,60,40-35,60
2199,4,0,-34,0,60,40-34,60
2200,4,0,-33,0,60,40-33,60
2201,4,0,-32,0,60,40-32,60
2202,4,0,-31,0,60,40-31,60
2203,4,0,-30,0,60,40-30,60
2204,4,0,-29,0,60,40-29,60
2205,4,0,-28,0,60,40-28,60
2206,4,0,-27,0,60,40-27,60
2207,4,0,-26,0,60,40-26,60
2208,4,0,-25,0,60,40-25,60
2209,4,0,-24,0,60,40-24,60
2210,4,0,-23,0,60,40-23,60
2211,4,0,-22,0,72,40-22,72
2212,4,0,-21,0,94,40-21,94
2213,4,0,-20,0,79,40-20,79
2214,4,0,-19,0,85,40-19,85
2215,4,0,-18,0,83,40-18,83
2216,4,0,-17,0,88,40-17,88
2217,4,0,-16,0,97,40-16,97
2218,4,0,-15,0,146,40-15,146
2219,4,0,-14,0,143,40-14,143
2220,4,0,-13,0,184,40-13,184
2221,4,0,-12,0,214,40-12,214
2222,4,0,-11,0,216,40-11,216
2223,4,0,-10,0,261,40-10,261
2224,4,0,-9,0,289,40-9,289
2225,4,0,-8,0,325,40-8,325
2226,4,0,-7,0,318,40-7,318
2227,4,0,-6,0,349,40-6,349
2228,4,0,-5,2,316,40-5,318
2229,4,0,-4,4,327,40-4,331
2230,4,0,-3,17,328,40-3,345
2231,4,0,-2,27,295,40-2,322
2232,4,0,-1,41,194,40-1,235
2233,4,0,1,161,56,401,217
2234,4,0,2,270,43,402,313
2235,4,0,3,315,16,403,331
2236,4,0,4,282,4,404,286
2237,4,0,5,289,4,405,293
2238,4,0,6,298,1,406,299
2239,4,0,7,273,1,407,274
2240,4,0,8,227,0,408,227
2241,4,0,9,184,0,409,184
2242,4,0,10,149,0,4010,149
2243,4,0,11,108,0,4011,108
2244,4,0,12,102,0,4012,102
2245,4,0,13,109,0,4013,109
2246,4,0,14,94,0,4014,94
2247,4,0,15,60,0,4015,60
2248,4,0,16,60,0,4016,60
2249,4,0,17,59,1,4017,60
2250,4,0,18,60,0,4018,60
2251,4,0,19,59,1,4019,60
2252,4,0,20,60,0,4020,60
2253,4,0,21,60,0,4021,60
2254,4,0,22,60,0,4022,60
2255,4,0,23,60,0,4023,60
2256,4,0,24,60,0,4024,60
2257,4,0,25,60,0,4025,60
2258,4,0,26,60,0,4026,60
2259,4,0,27,60,0,4027,60
2260,4,0,28,60,0,4028,60
2261,4,0,29,60,0,4029,60
2262,4,0,30,60,0,4030,60
2263,4,0,31,60,0,4031,60
2264,4,0,32,60,0,4032,60
2265,4,0,33,60,0,4033,60
2266,4,0,34,60,0,4034,60
2267,4,0,35,60,0,4035,60
2268,4,0,39,60,0,4039,60
2269,4,0,44,60,0,4044,60
2270,4,0,50,60,0,4050,60
2271,4,0,52,60,0,4052,60
2272,4,0,53,59,1,4053,60
2273,4,0,54,59,1,4054,60
2274,4,0,58,59,1,4058,60
2275,4,1,-45,0,60,41-45,60
2276,4,1,-44,0,60,41-44,60
2277,4,1,-43,0,60,41-43,60
2278,4,1,-42,0,60,41-42,60
2279,4,1,-41,0,60,41-41,60
2280,4,1,-40,0,60,41-40,60
2281,4,1,-39,0,60,41-39,60
2282,4,1,-38,0,60,41-38,60
2283,4,1,-37,0,60,41-37,60
2284,4,1,-36,0,60,41-36,60
2285,4,1,-35,0,60,41-35,60
2286,4,1,-34,0,60,41-34,60
2287,4,1,-33,0,60,41-33,60
2288,4,1,-32,0,60,41-32,60
2289,4,1,-31,0,60,41-31,60
2290,4,1,-30,0,60,41-30,60
2291,4,1,-29,0,60,41-29,60
2292,4,1,-28,0,60,41-28,60
2293,4,1,-27,0,60,41-27,60
2294,4,1,-26,0,60,41-26,60
2295,4,1,-25,0,62,41-25,62
2296,4,1,-24,0,68,41-24,68
2297,4,1,-23,0,60,41-23,60
2298,4,1,-22,0,60,41-22,60
2299,4,1,-21,0,60,41-21,60
2300,4,1,-20,1,59,41-20,60
2301,4,1,-19,0,67,41-19,67
2302,4,1,-18,0,63,41-18,63
2303,4,1,-17,0,74,41-17,74
2304,4,1,-16,0,80,41-16,80
2305,4,1,-15,0,85,41-15,85
2306,4,1,-14,0,106,41-14,106
2307,4,1,-13,0,115,41-13,115
2308,4,1,-12,0,110,41-12,110
2309,4,1,-11,0,116,41-11,116
2310,4,1,-10,0,107,41-10,107
2311,4,1,-9,0,112,41-9,112
2312,4,1,-8,0,147,41-8,147
2313,4,1,-7,1,141,41-7,142
2314,4,1,-6,1,134,41-6,135
2315,4,1,-5,5,123,41-5,128
2316,4,1,-4,10,108,41-4,118
2317,4,1,-3,22,121,41-3,143
2318,4,1,-2,34,94,41-2,128
2319,4,1,-1,36,75,41-1,111
2320,4,1,1,73,47,411,120
2321,4,1,2,93,39,412,132
2322,4,1,3,108,26,413,134
2323,4,1,4,97,18,414,115
2324,4,1,5,91,10,415,101
2325,4,1,6,84,3,416,87
2326,4,1,7,95,0,417,95
2327,4,1,8,87,0,418,87
2328,4,1,9,99,0,419,99
2329,4,1,10,96,0,4110,96
2330,4,1,11,75,0,4111,75
2331,4,1,12,63,0,4112,63
2332,4,1,13,59,1,4113,60
2333,4,1,14,59,1,4114,60
2334,4,1,15,60,0,4115,60
2335,4,1,16,60,0,4116,60
2336,4,1,17,58,2,4117,60
2337,4,1,18,60,0,4118,60
2338,4,1,19,60,0,4119,60
2339,4,1,20,60,0,4120,60
2340,4,1,21,60,0,4121,60
2341,4,1,22,60,0,4122,60
2342,4,1,23,60,0,4123,60
2343,4,1,24,60,0,4124,60
2344,4,1,25,60,0,4125,60
2345,4,1,26,60,0,4126,60
2346,4,1,27,60,0,4127,60
2347,4,1,28,60,0,4128,60
2348,4,1,29,60,0,4129,60
2349,4,1,30,60,0,4130,60
2350,4,1,31,60,0,4131,60
2351,4,1,32,60,0,4132,60
2352,4,1,33,60,0,4133,60
2353,4,1,34,60,0,4134,60
2354,4,1,42,60,0,4142,60
2355,4,1,44,60,0,4144,60
2356,4,1,46,60,0,4146,60
2357,4,1,48,60,0,4148,60
2358,4,1,51,60,0,4151,60
2359,4,1,53,59,1,4153,60
2360,4,1,55,58,2,4155,60
2361,4,1,57,60,0,4157,60
2362,4,1,58,59,1,4158,60
2363,4,2,-44,0,60,42-44,60
2364,4,2,-43,0,60,42-43,60
2365,4,2,-42,0,60,42-42,60
2366,4,2,-41,0,60,42-41,60
2367,4,2,-40,0,60,42-40,60
2368,4,2,-39,0,60,42-39,60
2369,4,2,-38,0,60,42-38,60
2370,4,2,-37,0,60,42-37,60
2371,4,2,-36,0,60,42-36,60
2372,4,2,-35,0,60,42-35,60
2373,4,2,-34,0,60,42-34,60
2374,4,2,-33,0,60,42-33,60
2375,4,2,-32,0,60,42-32,60
2376,4,2,-31,0,60,42-31,60
2377,4,2,-30,0,60,42-30,60
2378,4,2,-29,0,60,42-29,60
2379,4,2,-28,0,60,42-28,60
2380,4,2,-27,0,60,42-27,60
2381,4,2,-26,0,60,42-26,60
2382,4,2,-25,0,60,42-25,60
2383,4,2,-24,0,60,42-24,60
2384,4,2,-23,0,60,42-23,60
2385,4,2,-22,0,60,42-22,60
2386,4,2,-21,0,60,42-21,60
2387,4,2,-20,0,60,42-20,60
2388,4,2,-19,0,74,42-19,74
2389,4,2,-18,0,69,42-18,69
2390,4,2,-17,0,104,42-17,104
2391,4,2,-16,0,73,42-16,73
2392,4,2,-15,0,76,42-15,76
2393,4,2,-14,0,84,42-14,84
2394,4,2,-13,0,84,42-13,84
2395,4,2,-12,0,105,42-12,105
2396,4,2,-11,0,101,42-11,101
2397,4,2,-10,1,110,42-10,111
2398,4,2,-9,1,108,42-9,109
2399,4,2,-8,2,116,42-8,118
2400,4,2,-7,2,125,42-7,127
2401,4,2,-6,3,104,42-6,107
2402,4,2,-5,9,104,42-5,113
2403,4,2,-4,20,106,42-4,126
2404,4,2,-3,30,86,42-3,116
2405,4,2,-2,39,84,42-2,123
2406,4,2,-1,46,73,42-1,119
2407,4,2,1,54,47,421,101
2408,4,2,2,66,41,422,107
2409,4,2,3,76,21,423,97
2410,4,2,4,100,17,424,117
2411,4,2,5,97,12,425,109
2412,4,2,6,83,7,426,90
2413,4,2,7,74,4,427,78
2414,4,2,8,72,1,428,73
2415,4,2,9,73,1,429,74
2416,4,2,10,68,0,4210,68
2417,4,2,11,60,1,4211,61
2418,4,2,12,58,2,4212,60
2419,4,2,13,59,1,4213,60
2420,4,2,14,57,3,4214,60
2421,4,2,15,59,1,4215,60
2422,4,2,16,60,0,4216,60
2423,4,2,17,59,1,4217,60
2424,4,2,18,60,0,4218,60
2425,4,2,19,60,0,4219,60
2426,4,2,20,60,0,4220,60
2427,4,2,21,60,0,4221,60
2428,4,2,22,60,0,4222,60
2429,4,2,23,60,0,4223,60
2430,4,2,24,60,0,4224,60
2431,4,2,25,60,0,4225,60
2432,4,2,26,60,0,4226,60
2433,4,2,27,60,0,4227,60
2434,4,2,28,60,0,4228,60
2435,4,2,29,60,0,4229,60
2436,4,2,30,60,0,4230,60
2437,4,2,31,60,0,4231,60
2438,4,2,32,60,0,4232,60
2439,4,2,33,60,0,4233,60
2440,4,2,34,60,0,4234,60
2441,4,2,35,60,0,4235,60
2442,4,2,40,60,0,4240,60
2443,4,2,45,60,0,4245,60
2444,4,2,47,60,0,4247,60
2445,4,2,50,60,0,4250,60
2446,4,2,55,59,1,4255,60
2447,4,2,56,59,1,4256,60
2448,4,2,57,58,2,4257,60
2449,4,3,-47,0,60,43-47,60
2450,4,3,-45,0,60,43-45,60
2451,4,3,-43,0,60,43-43,60
2452,4,3,-41,0,60,43-41,60
2453,4,3,-40,0,60,43-40,60
2454,4,3,-39,0,60,43-39,60
2455,4,3,-38,0,60,43-38,60
2456,4,3,-37,0,60,43-37,60
2457,4,3,-36,0,60,43-36,60
2458,4,3,-35,0,60,43-35,60
2459,4,3,-34,0,60,43-34,60
2460,4,3,-33,0,60,43-33,60
2461,4,3,-32,0,60,43-32,60
2462,4,3,-31,0,60,43-31,60
2463,4,3,-30,0,60,43-30,60
2464,4,3,-29,0,60,43-29,60
2465,4,3,-28,0,60,43-28,60
2466,4,3,-27,0,60,43-27,60
2467,4,3,-26,0,60,43-26,60
2468,4,3,-25,0,60,43-25,60
2469,4,3,-24,0,60,43-24,60
2470,4,3,-23,0,60,43-23,60
2471,4,3,-22,0,66,43-22,66
2472,4,3,-21,0,71,43-21,71
2473,4,3,-20,0,80,43-20,80
2474,4,3,-19,0,81,43-19,81
2475,4,3,-18,0,82,43-18,82
2476,4,3,-17,0,93,43-17,93
2477,4,3,-16,0,83,43-16,83
2478,4,3,-15,0,70,43-15,70
2479,4,3,-14,0,83,43-14,83
2480,4,3,-13,0,87,43-13,87
2481,4,3,-12,2,104,43-12,106
2482,4,3,-11,3,106,43-11,109
2483,4,3,-10,4,96,43-10,100
2484,4,3,-9,1,95,43-9,96
2485,4,3,-8,6,107,43-8,113
2486,4,3,-7,8,114,43-7,122
2487,4,3,-6,12,116,43-6,128
2488,4,3,-5,12,107,43-5,119
2489,4,3,-4,15,110,43-4,125
2490,4,3,-3,27,82,43-3,109
2491,4,3,-2,37,79,43-2,116
2492,4,3,-1,41,65,43-1,106
2493,4,3,1,61,43,431,104
2494,4,3,2,73,41,432,114
2495,4,3,3,83,33,433,116
2496,4,3,4,78,20,434,98
2497,4,3,5,74,8,435,82
2498,4,3,6,78,10,436,88
2499,4,3,7,82,5,437,87
2500,4,3,8,60,7,438,67
2501,4,3,9,67,4,439,71
2502,4,3,10,56,4,4310,60
2503,4,3,11,59,1,4311,60
2504,4,3,12,59,1,4312,60
2505,4,3,13,60,0,4313,60
2506,4,3,14,58,2,4314,60
2507,4,3,15,58,2,4315,60
2508,4,3,16,60,0,4316,60
2509,4,3,17,60,0,4317,60
2510,4,3,18,60,0,4318,60
2511,4,3,19,60,0,4319,60
2512,4,3,20,60,0,4320,60
2513,4,3,21,59,1,4321,60
2514,4,3,22,60,0,4322,60
2515,4,3,23,60,0,4323,60
2516,4,3,24,60,0,4324,60
2517,4,3,25,60,0,4325,60
2518,4,3,26,60,0,4326,60
2519,4,3,27,60,0,4327,60
2520,4,3,28,60,0,4328,60
2521,4,3,29,60,0,4329,60
2522,4,3,30,60,0,4330,60
2523,4,3,31,60,0,4331,60
2524,4,3,32,59,1,4332,60
2525,4,3,33,60,0,4333,60
2526,4,3,34,60,0,4334,60
2527,4,3,35,60,0,4335,60
2528,4,3,36,60,0,4336,60
2529,4,3,37,60,0,4337,60
2530,4,3,38,60,0,4338,60
2531,4,3,46,60,0,4346,60
2532,4,3,47,60,0,4347,60
2533,4,3,48,60,0,4348,60
2534,4,3,56,60,0,4356,60
2535,4,3,57,60,0,4357,60
2536,4,3,58,60,0,4358,60
2537,4,4,-49,0,60,44-49,60
2538,4,4,-46,0,60,44-46,60
2539,4,4,-45,0,60,44-45,60
2540,4,4,-44,0,60,44-44,60
2541,4,4,-41,0,60,44-41,60
2542,4,4,-40,0,60,44-40,60
2543,4,4,-39,0,60,44-39,60
2544,4,4,-38,0,60,44-38,60
2545,4,4,-37,0,60,44-37,60
2546,4,4,-36,0,60,44-36,60
2547,4,4,-35,0,60,44-35,60
2548,4,4,-34,0,60,44-34,60
2549,4,4,-33,0,60,44-33,60
2550,4,4,-32,0,60,44-32,60
2551,4,4,-31,0,60,44-31,60
2552,4,4,-30,0,60,44-30,60
2553,4,4,-29,0,60,44-29,60
2554,4,4,-28,0,60,44-28,60
2555,4,4,-27,0,60,44-27,60
2556,4,4,-26,0,60,44-26,60
2557,4,4,-25,0,60,44-25,60
2558,4,4,-24,0,60,44-24,60
2559,4,4,-23,0,60,44-23,60
2560,4,4,-22,0,60,44-22,60
2561,4,4,-21,0,60,44-21,60
2562,4,4,-20,0,70,44-20,70
2563,4,4,-19,0,71,44-19,71
2564,4,4,-18,0,85,44-18,85
2565,4,4,-17,0,93,44-17,93
2566,4,4,-16,0,67,44-16,67
2567,4,4,-15,0,97,44-15,97
2568,4,4,-14,1,71,44-14,72
2569,4,4,-13,2,90,44-13,92
2570,4,4,-12,2,94,44-12,96
2571,4,4,-11,2,108,44-11,110
2572,4,4,-10,5,107,44-10,112
2573,4,4,-9,7,114,44-9,121
2574,4,4,-8,5,103,44-8,108
2575,4,4,-7,7,104,44-7,111
2576,4,4,-6,16,107,44-6,123
2577,4,4,-5,20,103,44-5,123
2578,4,4,-4,27,93,44-4,120
2579,4,4,-3,33,83,44-3,116
2580,4,4,-2,35,92,44-2,127
2581,4,4,-1,41,63,44-1,104
2582,4,4,1,68,51,441,119
2583,4,4,2,77,35,442,112
2584,4,4,3,69,33,443,102
2585,4,4,4,1520,77,444,1597
2586,4,4,4,25,35,444,60
2587,4,4,5,76,23,445,99
2588,4,4,6,61,13,446,74
2589,4,4,7,65,6,447,71
2590,4,4,8,61,9,448,70
2591,4,4,9,57,3,449,60
2592,4,4,10,57,4,4410,61
2593,4,4,11,58,2,4411,60
2594,4,4,12,59,1,4412,60
2595,4,4,13,58,2,4413,60
2596,4,4,14,60,0,4414,60
2597,4,4,15,59,1,4415,60
2598,4,4,16,59,1,4416,60
2599,4,4,17,60,0,4417,60
2600,4,4,18,60,0,4418,60
2601,4,4,19,60,0,4419,60
2602,4,4,20,60,0,4420,60
2603,4,4,21,60,0,4421,60
2604,4,4,22,60,0,4422,60
2605,4,4,23,60,0,4423,60
2606,4,4,24,60,0,4424,60
2607,4,4,25,60,0,4425,60
2608,4,4,26,60,0,4426,60
2609,4,4,27,60,0,4427,60
2610,4,4,28,60,0,4428,60
2611,4,4,29,60,0,4429,60
2612,4,4,30,60,0,4430,60
2613,4,4,31,60,0,4431,60
2614,4,4,32,60,0,4432,60
2615,4,4,33,60,0,4433,60
2616,4,4,34,60,0,4434,60
2617,4,4,35,60,0,4435,60
2618,4,4,36,60,0,4436,60
2619,4,4,43,60,0,4443,60
2620,4,4,44,59,1,4444,60
2621,4,4,46,60,0,4446,60
2622,4,4,57,60,0,4457,60
2623,4,4,58,60,0,4458,60
2624,4,5,-44,0,60,45-44,60
2625,4,5,-42,0,60,45-42,60
2626,4,5,-41,0,60,45-41,60
2627,4,5,-40,0,60,45-40,60
2628,4,5,-39,0,60,45-39,60
2629,4,5,-38,0,60,45-38,60
2630,4,5,-37,0,60,45-37,60
2631,4,5,-36,0,60,45-36,60
2632,4,5,-35,0,60,45-35,60
2633,4,5,-34,0,60,45-34,60
2634,4,5,-33,0,60,45-33,60
2635,4,5,-32,0,60,45-32,60
2636,4,5,-31,0,60,45-31,60
2637,4,5,-30,0,60,45-30,60
2638,4,5,-29,0,60,45-29,60
2639,4,5,-28,0,60,45-28,60
2640,4,5,-27,0,60,45-27,60
2641,4,5,-26,0,60,45-26,60
2642,4,5,-25,0,60,45-25,60
2643,4,5,-24,0,60,45-24,60
2644,4,5,-23,0,60,45-23,60
2645,4,5,-22,0,60,45-22,60
2646,4,5,-21,0,60,45-21,60
2647,4,5,-20,0,60,45-20,60
2648,4,5,-19,0,60,45-19,60
2649,4,5,-18,0,87,45-18,87
2650,4,5,-17,0,92,45-17,92
2651,4,5,-16,0,91,45-16,91
2652,4,5,-15,3,95,45-15,98
2653,4,5,-14,2,70,45-14,72
2654,4,5,-13,2,90,45-13,92
2655,4,5,-12,1,84,45-12,85
2656,4,5,-11,2,85,45-11,87
2657,4,5,-10,2,88,45-10,90
2658,4,5,-9,3,106,45-9,109
2659,4,5,-8,5,112,45-8,117
2660,4,5,-7,11,101,45-7,112
2661,4,5,-6,12,111,45-6,123
2662,4,5,-5,21,92,45-5,113
2663,4,5,-4,26,93,45-4,119
2664,4,5,-3,40,101,45-3,141
2665,4,5,-2,39,78,45-2,117
2666,4,5,-1,49,69,45-1,118
2667,4,5,1,52,45,451,97
2668,4,5,2,68,49,452,117
2669,4,5,3,68,42,453,110
2670,4,5,4,82,14,454,96
2671,4,5,5,60,20,455,80
2672,4,5,6,71,14,456,85
2673,4,5,7,73,13,457,86
2674,4,5,8,65,9,458,74
2675,4,5,9,62,7,459,69
2676,4,5,10,56,6,4510,62
2677,4,5,11,57,3,4511,60
2678,4,5,12,59,1,4512,60
2679,4,5,13,59,1,4513,60
2680,4,5,14,59,1,4514,60
2681,4,5,15,60,0,4515,60
2682,4,5,16,59,1,4516,60
2683,4,5,17,60,0,4517,60
2684,4,5,18,60,0,4518,60
2685,4,5,19,60,0,4519,60
2686,4,5,20,60,0,4520,60
2687,4,5,21,60,0,4521,60
2688,4,5,22,60,0,4522,60
2689,4,5,23,60,0,4523,60
2690,4,5,24,60,0,4524,60
2691,4,5,25,60,0,4525,60
2692,4,5,26,60,0,4526,60
2693,4,5,27,60,0,4527,60
2694,4,5,28,60,0,4528,60
2695,4,5,29,60,0,4529,60
2696,4,5,30,60,0,4530,60
2697,4,5,31,60,0,4531,60
2698,4,5,32,60,0,4532,60
2699,4,5,33,60,0,4533,60
2700,4,5,34,60,0,4534,60
2701,4,5,35,60,0,4535,60
2702,4,5,37,60,0,4537,60
2703,4,5,41,60,0,4541,60
2704,4,5,43,60,0,4543,60
2705,4,5,44,60,0,4544,60
2706,4,5,46,59,1,4546,60
2707,4,5,51,57,3,4551,60
2708,4,5,53,60,0,4553,60
2709,4,5,56,60,0,4556,60
2710,4,6,-44,0,60,46-44,60
2711,4,6,-42,0,60,46-42,60
2712,4,6,-41,0,60,46-41,60
2713,4,6,-40,0,60,46-40,60
2714,4,6,-39,0,60,46-39,60
2715,4,6,-38,0,60,46-38,60
2716,4,6,-37,0,60,46-37,60
2717,4,6,-36,0,60,46-36,60
2718,4,6,-35,0,60,46-35,60
2719,4,6,-34,0,60,46-34,60
2720,4,6,-33,0,60,46-33,60
2721,4,6,-32,0,60,46-32,60
2722,4,6,-31,0,60,46-31,60
2723,4,6,-30,0,60,46-30,60
2724,4,6,-29,0,60,46-29,60
2725,4,6,-28,0,60,46-28,60
2726,4,6,-27,0,60,46-27,60
2727,4,6,-26,0,60,46-26,60
2728,4,6,-25,0,60,46-25,60
2729,4,6,-24,0,60,46-24,60
2730,4,6,-23,0,60,46-23,60
2731,4,6,-22,0,60,46-22,60
2732,4,6,-21,0,60,46-21,60
2733,4,6,-20,0,67,46-20,67
2734,4,6,-19,0,64,46-19,64
2735,4,6,-18,0,60,46-18,60
2736,4,6,-17,2,89,46-17,91
2737,4,6,-16,1,77,46-16,78
2738,4,6,-15,1,95,46-15,96
2739,4,6,-14,1,98,46-14,99
2740,4,6,-13,1,99,46-13,100
2741,4,6,-12,3,76,46-12,79
2742,4,6,-11,2,91,46-11,93
2743,4,6,-10,6,91,46-10,97
2744,4,6,-9,6,76,46-9,82
2745,4,6,-8,6,94,46-8,100
2746,4,6,-7,13,88,46-7,101
2747,4,6,-6,16,97,46-6,113
2748,4,6,-5,17,110,46-5,127
2749,4,6,-4,23,96,46-4,119
2750,4,6,-3,39,97,46-3,136
2751,4,6,-2,45,75,46-2,120
2752,4,6,-1,65,73,46-1,138
2753,4,6,1,57,53,461,110
2754,4,6,2,56,41,462,97
2755,4,6,3,66,38,463,104
2756,4,6,4,60,28,464,88
2757,4,6,5,55,20,465,75
2758,4,6,6,59,19,466,78
2759,4,6,7,67,7,467,74
2760,4,6,8,80,7,468,87
2761,4,6,9,64,5,469,69
2762,4,6,10,62,4,4610,66
2763,4,6,11,49,11,4611,60
2764,4,6,12,55,5,4612,60
2765,4,6,13,56,4,4613,60
2766,4,6,14,60,0,4614,60
2767,4,6,15,59,1,4615,60
2768,4,6,16,60,0,4616,60
2769,4,6,17,59,1,4617,60
2770,4,6,18,59,1,4618,60
2771,4,6,19,60,0,4619,60
2772,4,6,20,60,0,4620,60
2773,4,6,21,60,0,4621,60
2774,4,6,22,60,0,4622,60
2775,4,6,23,60,0,4623,60
2776,4,6,24,60,0,4624,60
2777,4,6,25,60,0,4625,60
2778,4,6,26,60,0,4626,60
2779,4,6,27,60,0,4627,60
2780,4,6,28,60,0,4628,60
2781,4,6,29,60,0,4629,60
2782,4,6,30,60,0,4630,60
2783,4,6,31,60,0,4631,60
2784,4,6,38,60,0,4638,60
2785,4,6,39,59,1,4639,60
2786,4,6,40,60,0,4640,60
2787,4,6,42,60,0,4642,60
2788,4,6,48,60,0,4648,60
2789,4,6,50,60,0,4650,60
2790,4,7,-42,0,60,47-42,60
2791,4,7,-41,0,60,47-41,60
2792,4,7,-40,0,60,47-40,60
2793,4,7,-39,0,60,47-39,60
2794,4,7,-38,0,60,47-38,60
2795,4,7,-37,0,60,47-37,60
2796,4,7,-36,0,60,47-36,60
2797,4,7,-35,0,60,47-35,60
2798,4,7,-34,0,60,47-34,60
2799,4,7,-33,0,60,47-33,60
2800,4,7,-32,0,60,47-32,60
2801,4,7,-31,0,60,47-31,60
2802,4,7,-30,0,60,47-30,60
2803,4,7,-29,0,60,47-29,60
2804,4,7,-28,0,60,47-28,60
2805,4,7,-27,0,60,47-27,60
2806,4,7,-26,0,60,47-26,60
2807,4,7,-25,0,60,47-25,60
2808,4,7,-24,0,60,47-24,60
2809,4,7,-23,0,60,47-23,60
2810,4,7,-22,1,59,47-22,60
2811,4,7,-21,0,60,47-21,60
2812,4,7,-20,2,58,47-20,60
2813,4,7,-19,0,60,47-19,60
2814,4,7,-18,2,71,47-18,73
2815,4,7,-17,2,69,47-17,71
2816,4,7,-16,0,73,47-16,73
2817,4,7,-15,2,79,47-15,81
2818,4,7,-14,4,89,47-14,93
2819,4,7,-13,5,102,47-13,107
2820,4,7,-12,5,105,47-12,110
2821,4,7,-11,5,94,47-11,99
2822,4,7,-10,10,89,47-10,99
2823,4,7,-9,8,69,47-9,77
2824,4,7,-8,10,104,47-8,114
2825,4,7,-7,6,103,47-7,109
2826,4,7,-6,16,102,47-6,118
2827,4,7,-5,13,82,47-5,95
2828,4,7,-4,18,93,47-4,111
2829,4,7,-3,30,101,47-3,131
2830,4,7,-2,28,97,47-2,125
2831,4,7,-1,42,75,47-1,117
2832,4,7,1,52,55,471,107
2833,4,7,2,55,40,472,95
2834,4,7,3,58,29,473,87
2835,4,7,4,65,27,474,92
2836,4,7,5,65,23,475,88
2837,4,7,6,62,17,476,79
2838,4,7,7,61,11,477,72
2839,4,7,8,53,7,478,60
2840,4,7,9,53,7,479,60
2841,4,7,10,54,6,4710,60
2842,4,7,11,53,7,4711,60
2843,4,7,12,57,3,4712,60
2844,4,7,13,54,6,4713,60
2845,4,7,14,60,0,4714,60
2846,4,7,15,57,3,4715,60
2847,4,7,16,60,0,4716,60
2848,4,7,17,60,0,4717,60
2849,4,7,18,60,0,4718,60
2850,4,7,19,59,1,4719,60
2851,4,7,20,59,1,4720,60
2852,4,7,21,60,0,4721,60
2853,4,7,22,60,0,4722,60
2854,4,7,23,60,0,4723,60
2855,4,7,24,60,0,4724,60
2856,4,7,25,60,0,4725,60
2857,4,7,26,60,0,4726,60
2858,4,7,27,60,0,4727,60
2859,4,7,29,60,0,4729,60
2860,4,7,30,60,0,4730,60
2861,4,7,31,60,0,4731,60
2862,4,7,32,59,1,4732,60
2863,4,7,34,60,0,4734,60
2864,4,7,35,60,0,4735,60
2865,4,7,36,60,0,4736,60
2866,4,7,37,60,0,4737,60
2867,4,7,39,60,0,4739,60
2868,4,7,40,60,0,4740,60
2869,4,7,42,60,0,4742,60
2870,4,7,43,59,1,4743,60
2871,4,7,45,60,0,4745,60
2872,4,7,48,60,0,4748,60
2873,4,7,50,59,1,4750,60
2874,4,8,-46,0,60,48-46,60
2875,4,8,-45,0,60,48-45,60
2876,4,8,-44,0,60,48-44,60
2877,4,8,-43,0,60,48-43,60
2878,4,8,-40,0,60,48-40,60
2879,4,8,-39,0,60,48-39,60
2880,4,8,-38,0,60,48-38,60
2881,4,8,-37,0,60,48-37,60
2882,4,8,-36,0,60,48-36,60
2883,4,8,-35,0,60,48-35,60
2884,4,8,-34,0,60,48-34,60
2885,4,8,-33,0,60,48-33,60
2886,4,8,-32,0,60,48-32,60
2887,4,8,-31,0,60,48-31,60
2888,4,8,-30,0,60,48-30,60
2889,4,8,-29,0,60,48-29,60
2890,4,8,-28,0,60,48-28,60
2891,4,8,-27,0,60,48-27,60
2892,4,8,-26,0,60,48-26,60
2893,4,8,-25,0,60,48-25,60
2894,4,8,-24,0,60,48-24,60
2895,4,8,-23,0,60,48-23,60
2896,4,8,-22,0,60,48-22,60
2897,4,8,-21,0,60,48-21,60
2898,4,8,-20,0,60,48-20,60
2899,4,8,-19,0,60,48-19,60
2900,4,8,-18,1,69,48-18,70
2901,4,8,-17,1,62,48-17,63
2902,4,8,-16,3,81,48-16,84
2903,4,8,-15,2,82,48-15,84
2904,4,8,-14,3,82,48-14,85
2905,4,8,-13,2,95,48-13,97
2906,4,8,-12,3,83,48-12,86
2907,4,8,-11,3,81,48-11,84
2908,4,8,-10,3,82,48-10,85
2909,4,8,-9,2,87,48-9,89
2910,4,8,-8,13,100,48-8,113
2911,4,8,-7,16,101,48-7,117
2912,4,8,-6,22,92,48-6,114
2913,4,8,-5,19,87,48-5,106
2914,4,8,-4,21,79,48-4,100
2915,4,8,-3,37,86,48-3,123
2916,4,8,-2,37,72,48-2,109
2917,4,8,-1,41,80,48-1,121
2918,4,8,1,59,50,481,109
2919,4,8,2,54,40,482,94
2920,4,8,3,59,38,483,97
2921,4,8,4,50,31,484,81
2922,4,8,5,62,26,485,88
2923,4,8,6,58,12,486,70
2924,4,8,7,53,11,487,64
2925,4,8,8,52,9,488,61
2926,4,8,9,51,9,489,60
2927,4,8,10,52,8,4810,60
2928,4,8,11,55,5,4811,60
2929,4,8,12,55,5,4812,60
2930,4,8,13,59,1,4813,60
2931,4,8,14,59,1,4814,60
2932,4,8,15,58,2,4815,60
2933,4,8,16,58,2,4816,60
2934,4,8,17,60,0,4817,60
2935,4,8,18,60,0,4818,60
2936,4,8,19,60,0,4819,60
2937,4,8,20,60,0,4820,60
2938,4,8,21,60,0,4821,60
2939,4,8,22,60,0,4822,60
2940,4,8,23,60,0,4823,60
2941,4,8,24,60,0,4824,60
2942,4,8,25,60,0,4825,60
2943,4,8,26,60,0,4826,60
2944,4,8,27,60,0,4827,60
2945,4,8,28,60,0,4828,60
2946,4,8,29,60,0,4829,60
2947,4,8,30,60,0,4830,60
2948,4,8,31,60,0,4831,60
2949,4,8,32,60,0,4832,60
2950,4,8,33,59,1,4833,60
2951,4,8,34,60,0,4834,60
2952,4,8,35,60,0,4835,60
2953,4,8,36,60,0,4836,60
2954,4,8,37,59,1,4837,60
2955,4,8,39,60,0,4839,60
2956,4,8,41,60,0,4841,60
2957,4,8,44,60,0,4844,60
2958,4,8,45,60,0,4845,60
2959,4,8,46,60,0,4846,60
2960,4,8,48,59,1,4848,60
2961,4,9,-44,0,60,49-44,60
2962,4,9,-42,0,60,49-42,60
2963,4,9,-41,0,60,49-41,60
2964,4,9,-40,0,60,49-40,60
2965,4,9,-39,0,60,49-39,60
2966,4,9,-38,0,60,49-38,60
2967,4,9,-37,0,60,49-37,60
2968,4,9,-36,0,60,49-36,60
2969,4,9,-35,0,60,49-35,60
2970,4,9,-34,0,60,49-34,60
2971,4,9,-33,0,60,49-33,60
2972,4,9,-32,0,60,49-32,60
2973,4,9,-31,0,60,49-31,60
2974,4,9,-30,0,60,49-30,60
2975,4,9,-29,0,60,49-29,60
2976,4,9,-28,0,60,49-28,60
2977,4,9,-27,0,60,49-27,60
2978,4,9,-26,0,60,49-26,60
2979,4,9,-25,0,60,49-25,60
2980,4,9,-24,1,59,49-24,60
2981,4,9,-23,1,59,49-23,60
2982,4,9,-22,0,60,49-22,60
2983,4,9,-21,2,58,49-21,60
2984,4,9,-20,0,60,49-20,60
2985,4,9,-19,0,60,49-19,60
2986,4,9,-18,1,67,49-18,68
2987,4,9,-17,0,67,49-17,67
2988,4,9,-16,2,78,49-16,80
2989,4,9,-15,1,79,49-15,80
2990,4,9,-14,1,78,49-14,79
2991,4,9,-13,3,87,49-13,90
2992,4,9,-12,3,80,49-12,83
2993,4,9,-11,6,70,49-11,76
2994,4,9,-10,8,82,49-10,90
2995,4,9,-9,6,97,49-9,103
2996,4,9,-8,14,92,49-8,106
2997,4,9,-7,13,93,49-7,106
2998,4,9,-6,21,84,49-6,105
2999,4,9,-5,25,88,49-5,113
3000,4,9,-4,35,94,49-4,129
3001,4,9,-3,27,88,49-3,115
3002,4,9,-2,33,65,49-2,98
3003,4,9,-1,47,68,49-1,115
3004,4,9,1,57,53,491,110
3005,4,9,2,70,50,492,120
3006,4,9,3,69,36,493,105
3007,4,9,4,64,29,494,93
3008,4,9,5,47,23,495,70
3009,4,9,6,57,26,496,83
3010,4,9,7,48,15,497,63
3011,4,9,8,63,7,498,70
3012,4,9,9,58,6,499,64
3013,4,9,10,61,5,4910,66
3014,4,9,11,57,3,4911,60
3015,4,9,12,59,1,4912,60
3016,4,9,13,58,2,4913,60
3017,4,9,14,56,4,4914,60
3018,4,9,15,58,2,4915,60
3019,4,9,16,57,3,4916,60
3020,4,9,17,59,1,4917,60
3021,4,9,18,60,0,4918,60
3022,4,9,19,59,1,4919,60
3023,4,9,20,60,0,4920,60
3024,4,9,21,60,0,4921,60
3025,4,9,22,60,0,4922,60
3026,4,9,23,60,0,4923,60
3027,4,9,24,60,0,4924,60
3028,4,9,25,60,0,4925,60
3029,4,9,26,60,0,4926,60
3030,4,9,27,60,0,4927,60
3031,4,9,28,60,0,4928,60
3032,4,9,29,60,0,4929,60
3033,4,9,30,60,0,4930,60
3034,4,9,31,60,0,4931,60
3035,4,9,33,60,0,4933,60
3036,4,9,34,60,0,4934,60
3037,4,9,37,60,0,4937,60
3038,4,9,39,60,0,4939,60
3039,4,9,40,60,0,4940,60
3040,4,9,41,59,1,4941,60
3041,4,9,42,60,0,4942,60
3042,4,9,48,59,1,4948,60
3043,4,9,49,60,0,4949,60
3044,4,9,50,60,0,4950,60
3045,4,10,-42,0,60,410-42,60
3046,4,10,-41,0,60,410-41,60
3047,4,10,-40,0,60,410-40,60
3048,4,10,-39,0,60,410-39,60
3049,4,10,-38,0,60,410-38,60
3050,4,10,-37,0,60,410-37,60
3051,4,10,-36,0,60,410-36,60
3052,4,10,-35,0,60,410-35,60
3053,4,10,-34,0,60,410-34,60
3054,4,10,-33,0,60,410-33,60
3055,4,10,-32,0,60,410-32,60
3056,4,10,-31,0,60,410-31,60
3057,4,10,-30,0,60,410-30,60
3058,4,10,-29,0,60,410-29,60
3059,4,10,-28,0,60,410-28,60
3060,4,10,-27,0,60,410-27,60
3061,4,10,-26,0,60,410-26,60
3062,4,10,-25,0,60,410-25,60
3063,4,10,-24,0,60,410-24,60
3064,4,10,-23,1,59,410-23,60
3065,4,10,-22,0,60,410-22,60
3066,4,10,-21,0,60,410-21,60
3067,4,10,-20,0,60,410-20,60
3068,4,10,-19,0,60,410-19,60
3069,4,10,-18,1,59,410-18,60
3070,4,10,-17,0,65,410-17,65
3071,4,10,-16,0,77,410-16,77
3072,4,10,-15,0,72,410-15,72
3073,4,10,-14,4,73,410-14,77
3074,4,10,-13,3,84,410-13,87
3075,4,10,-12,5,86,410-12,91
3076,4,10,-11,6,91,410-11,97
3077,4,10,-10,14,91,410-10,105
3078,4,10,-9,7,89,410-9,96
3079,4,10,-8,13,78,410-8,91
3080,4,10,-7,12,85,410-7,97
3081,4,10,-6,18,93,410-6,111
3082,4,10,-5,10,91,410-5,101
3083,4,10,-4,26,96,410-4,122
3084,4,10,-3,36,72,410-3,108
3085,4,10,-2,46,92,410-2,138
3086,4,10,-1,50,83,410-1,133
3087,4,10,1,60,70,4101,130
3088,4,10,2,57,57,4102,114
3089,4,10,3,55,44,4103,99
3090,4,10,4,56,39,4104,95
3091,4,10,5,41,32,4105,73
3092,4,10,6,58,15,4106,73
3093,4,10,7,47,15,4107,62
3094,4,10,8,59,12,4108,71
3095,4,10,9,51,9,4109,60
3096,4,10,10,56,4,41010,60
3097,4,10,11,59,5,41011,64
3098,4,10,12,56,4,41012,60
3099,4,10,13,58,2,41013,60
3100,4,10,14,57,3,41014,60
3101,4,10,15,56,4,41015,60
3102,4,10,16,59,1,41016,60
3103,4,10,17,59,1,41017,60
3104,4,10,18,59,1,41018,60
3105,4,10,19,60,0,41019,60
3106,4,10,20,60,0,41020,60
3107,4,10,21,60,0,41021,60
3108,4,10,22,60,0,41022,60
3109,4,10,23,60,0,41023,60
3110,4,10,24,60,0,41024,60
3111,4,10,25,60,0,41025,60
3112,4,10,26,60,0,41026,60
3113,4,10,27,60,0,41027,60
3114,4,10,28,60,0,41028,60
3115,4,10,29,60,0,41029,60
3116,4,10,30,60,0,41030,60
3117,4,10,31,60,0,41031,60
3118,4,10,32,60,0,41032,60
3119,4,10,34,60,0,41034,60
3120,4,10,35,60,0,41035,60
3121,4,10,36,60,0,41036,60
3122,4,10,37,60,0,41037,60
3123,4,10,38,60,0,41038,60
3124,4,10,48,60,0,41048,60
3125,4,11,-43,0,60,411-43,60
3126,4,11,-41,0,60,411-41,60
3127,4,11,-40,0,60,411-40,60
3128,4,11,-39,0,60,411-39,60
3129,4,11,-38,0,60,411-38,60
3130,4,11,-37,0,60,411-37,60
3131,4,11,-36,0,60,411-36,60
3132,4,11,-35,0,60,411-35,60
3133,4,11,-34,0,60,411-34,60
3134,4,11,-33,0,60,411-33,60
3135,4,11,-32,0,60,411-32,60
3136,4,11,-31,0,60,411-31,60
3137,4,11,-30,0,60,411-30,60
3138,4,11,-29,0,60,411-29,60
3139,4,11,-28,0,60,411-28,60
3140,4,11,-27,0,60,411-27,60
3141,4,11,-26,0,60,411-26,60
3142,4,11,-25,0,60,411-25,60
3143,4,11,-24,1,59,411-24,60
3144,4,11,-23,2,58,411-23,60
3145,4,11,-22,0,60,411-22,60
3146,4,11,-21,1,59,411-21,60
3147,4,11,-20,0,60,411-20,60
3148,4,11,-19,0,60,411-19,60
3149,4,11,-18,1,59,411-18,60
3150,4,11,-17,0,60,411-17,60
3151,4,11,-16,2,58,411-16,60
3152,4,11,-15,0,60,411-15,60
3153,4,11,-14,1,59,411-14,60
3154,4,11,-13,3,61,411-13,64
3155,4,11,-12,5,58,411-12,63
3156,4,11,-11,7,83,411-11,90
3157,4,11,-10,7,55,411-10,62
3158,4,11,-9,6,82,411-9,88
3159,4,11,-8,6,82,411-8,88
3160,4,11,-7,6,75,411-7,81
3161,4,11,-6,11,62,411-6,73
3162,4,11,-5,16,67,411-5,83
3163,4,11,-4,18,73,411-4,91
3164,4,11,-3,22,59,411-3,81
3165,4,11,-2,30,74,411-2,104
3166,4,11,-1,33,49,411-1,82
3167,4,11,1,44,38,4111,82
3168,4,11,2,50,38,4112,88
3169,4,11,3,32,31,4113,63
3170,4,11,4,40,22,4114,62
3171,4,11,5,46,19,4115,65
3172,4,11,6,51,25,4116,76
3173,4,11,7,43,17,4117,60
3174,4,11,8,47,13,4118,60
3175,4,11,9,46,14,4119,60
3176,4,11,10,58,6,41110,64
3177,4,11,11,52,8,41111,60
3178,4,11,12,59,1,41112,60
3179,4,11,13,58,2,41113,60
3180,4,11,14,59,1,41114,60
3181,4,11,15,56,4,41115,60
3182,4,11,16,58,2,41116,60
3183,4,11,17,59,1,41117,60
3184,4,11,18,59,1,41118,60
3185,4,11,19,59,1,41119,60
3186,4,11,20,59,1,41120,60
3187,4,11,21,60,0,41121,60
3188,4,11,22,60,0,41122,60
3189,4,11,23,60,0,41123,60
3190,4,11,24,60,0,41124,60
3191,4,11,25,60,0,41125,60
3192,4,11,26,60,0,41126,60
3193,4,11,27,60,0,41127,60
3194,4,11,28,60,0,41128,60
3195,4,11,29,60,0,41129,60
3196,4,11,30,60,0,41130,60
3197,4,11,31,60,0,41131,60
3198,4,11,32,60,0,41132,60
3199,4,11,33,60,0,41133,60
3200,4,11,34,59,1,41134,60
3201,4,11,35,60,0,41135,60
3202,4,11,36,60,0,41136,60
3203,4,11,43,60,0,41143,60
3204,4,11,46,60,0,41146,60
3205,4,12,-42,0,60,412-42,60
3206,4,12,-41,0,60,412-41,60
3207,4,12,-40,0,60,412-40,60
3208,4,12,-39,0,60,412-39,60
3209,4,12,-37,0,60,412-37,60
3210,4,12,-36,0,60,412-36,60
3211,4,12,-34,0,60,412-34,60
3212,4,12,-33,0,60,412-33,60
3213,4,12,-32,0,60,412-32,60
3214,4,12,-31,0,60,412-31,60
3215,4,12,-30,0,60,412-30,60
3216,4,12,-29,0,60,412-29,60
3217,4,12,-28,0,60,412-28,60
3218,4,12,-27,0,60,412-27,60
3219,4,12,-26,0,60,412-26,60
3220,4,12,-25,0,60,412-25,60
3221,4,12,-24,0,60,412-24,60
3222,4,12,-23,0,60,412-23,60
3223,4,12,-22,0,60,412-22,60
3224,4,12,-21,1,59,412-21,60
3225,4,12,-20,1,59,412-20,60
3226,4,12,-19,0,60,412-19,60
3227,4,12,-18,1,59,412-18,60
3228,4,12,-17,0,60,412-17,60
3229,4,12,-16,0,60,412-16,60
3230,4,12,-15,1,59,412-15,60
3231,4,12,-14,4,56,412-14,60
3232,4,12,-13,3,57,412-13,60
3233,4,12,-12,2,58,412-12,60
3234,4,12,-11,1,59,412-11,60
3235,4,12,-10,2,58,412-10,60
3236,4,12,-9,4,56,412-9,60
3237,4,12,-8,12,48,412-8,60
3238,4,12,-7,10,64,412-7,74
3239,4,12,-6,8,52,412-6,60
3240,4,12,-5,14,46,412-5,60
3241,4,12,-4,21,47,412-4,68
3242,4,12,-3,14,46,412-3,60
3243,4,12,-2,16,44,412-2,60
3244,4,12,-1,32,37,412-1,69
3245,4,12,1,34,26,4121,60
3246,4,12,2,31,29,4122,60
3247,4,12,3,37,23,4123,60
3248,4,12,4,36,24,4124,60
3249,4,12,5,41,19,4125,60
3250,4,12,6,45,15,4126,60
3251,4,12,7,47,13,4127,60
3252,4,12,8,53,7,4128,60
3253,4,12,9,51,9,4129,60
3254,4,12,10,57,3,41210,60
3255,4,12,11,56,4,41211,60
3256,4,12,12,56,4,41212,60
3257,4,12,13,56,4,41213,60
3258,4,12,14,57,3,41214,60
3259,4,12,15,59,1,41215,60
3260,4,12,16,59,1,41216,60
3261,4,12,17,60,0,41217,60
3262,4,12,18,59,1,41218,60
3263,4,12,19,60,0,41219,60
3264,4,12,20,60,0,41220,60
3265,4,12,21,59,1,41221,60
3266,4,12,22,60,0,41222,60
3267,4,12,23,60,0,41223,60
3268,4,12,24,60,0,41224,60
3269,4,12,25,60,0,41225,60
3270,4,12,26,60,0,41226,60
3271,4,12,27,60,0,41227,60
3272,4,12,28,60,0,41228,60
3273,4,12,29,60,0,41229,60
3274,4,12,31,60,0,41231,60
3275,4,12,33,60,0,41233,60
3276,4,12,35,60,0,41235,60
3277,4,12,38,60,0,41238,60
3278,4,12,39,60,0,41239,60
